apples	リンゴ
cabbages	キャベツ
cake	ケーキ
carrots	ニンジン
cooking	料理
corn	トウモロコシ
cucumbers	キュウリ
cup	カップ
eat	食べる
eggplants	ナス
elephant	ゾウ
fish	魚
juice	ジュース
leaf	葉
lemons	レモン
lettuces	レタス
lunch	昼ごはん
melons	メロン
mushrooms	キノコ
onions	タマネギ
oranges	オレンジ
peaches	モモ
pie	パイ
pineapples	パイナップル
potatoes	ジャガイモ
pumpkins	カボチャ
restaurant	レストラン
strawberry	イチゴ
tomatoes	トマト
watermelons	スイカ
