teenage	十代	anc
platinum	プラチナ(色･金属元素)	anc
watt	ワット(電力･工率の単位)	anc
illness	不健康|病気	anc
expense	支出	anc
modeling	モデリング	anc
inform	知らせる	anc
atmosphere	雰囲気|環境|空気|気圧|媒体ガス|触媒|大気	anc
jam	混雑|ジャム|妨害する|詰め込む	anc
alternate	かわるがわる|互い違いの	anc
memorabilia	記憶すべきこと･もの	anc
pitch	ピッチ|程度|投げる|(テントを)張る	anc
shield	かばう|シールド|盾|防御物|を保護する	anc
strain	傾向|素質|話し(書き)ぶり|旋律|気質|緊張させる|ぴんと張る|痛める	original
bread	パン	anc
behaviour	行動	anc
trainer	訓練者|コーチ|指導者|練習機	anc
electricity	電気学|電気(学)|気学|電流|電力	anc
compilation	編集|編集物|寄せ集め	anc
harbor	(考え･計画など)を心にいだく|をかくまう|港|避難所	anc
thick	厚い|分厚い|混雑している|濃い|深い|鈍い|太い部分|賑やかなところ|(方言などが)明瞭にわかる	anc
flame	光彩|炎|情熱|火炎|光輝|激情	anc
declaration	宣言|通知|申告	anc
aspect	面|様子|外観|性状|顔つき|姿|(文法)動詞の相|アスペクト	anc
awesome	すごい|とてもいい	anc
pizza	ピザ(パイ)	anc
screw	ねじくぎ|木ネジ|スクリュー|らせん状のもの|苦しめる|痛めつける|をねじ釘で取り付ける	anc
candy	キャンデー	anc
federation	連邦|連盟|連邦政府|同盟|組合|連合	anc
hist	シーッ|静かに|静まる|シーと言って追い立てる	anc
consult	に助言を求める|意見を聞く|に相談する|を参考にする|を調べる	anc
torture	を拷問にかける|苦しめる|ねじる|拷問|苦痛|歪曲	anc
passion	激情|熱情|感情|熱中	anc
tile	タイル|かわら|化粧タイル|牌	anc
prospect	予想|候補者|見晴らし|観察|を調査する	anc
advocate	弁護する|擁護する|主張する|弁護士|支持者|運動家	anc
involvement	関わり|巻き込むこと	anc
incorporate	を具体化する|法人組織にする|合併する|組込む|受け入れる	anc
pursue	を追求する|追う|を続ける|実行する	anc
shoot	を撃つ|を射る|シュート(する)	anc
deputy	代理人|副～|代理|副|代理の	anc
worship	礼拝する|崇拝する|礼拝|賛美|を崇拝する	anc
supplement	補足|追加|補遺|補角|を補う	anc
probability	ありそうな事柄|ありそうなこと|蓋然性|見込み|公算|確率|可能性	anc
petition	嘆願|請願(書)|申し立て(書)|を請求する|を願う	anc
eligibility	適任|適格(性)|有資格	anc
booty	盗品|戦利品|略奪品	anc
hub	(車輪の)ハブ|中心|集線装置	anc
alien	在留外国人|異邦人|異星人	anc
excel	しのぐ|優る	anc
chase	を追う|を追跡する|を追い払う|追撃|狩り	anc
subsequent	それに続く|その後の|次の|後に来る	anc
arch	アーチ|弓形|主な|主要な|土踏まず	anc
viewer	見る人|見物人|検査官|テレビ視聴者|聴視者|観覧者	anc
radiation	放射線|放射|輻射|放熱	original
licence	許可する|に免許を許す|免許(証)|気まま|破格	anc
shade	陰|光(熱)をさえぎるもの|陰影|わずかな違い|を陰にする|サングラス	anc
grain	穀物|種子|粒|少量|1粒|グレイン|粒にする|木目	anc
moral	道徳の|道徳的な|精神的な|教訓|品行	anc
pride	プライド|誇る|自尊心|高慢|うぬぼれ|横柄|尊大|自慢の種|全盛	anc
arrow	矢	anc
cord	コード|紐	original
adequate	適した|適当な|適切な|十分な	anc
shit	排便行為|(俗)くそ|たわごと|くだらないもの(奴)	anc
receptor	レセプター(受容体)	anc
powder	パウダー|粉	anc
hence	それゆえに|今から先|故に|今後	anc
tap	こつこつ叩く|開発する|引き出す|栓を抜く|靴の音|飲み口|栓|蛇口|盗聴|電話盗聴(傍受)装置|盗聴する	original
entirely	全く	anc
rider	ライダー	anc
cure	を治療する|(悪い習慣など)を直す|治療法	anc
ion	イオン	original
syndrome	シンドローム|症候群(病的諸傾向)|一連の事物(事件)|ある状況下での行動様式|病的現象	anc
diagnostic	診断の	anc
closely	きっちりと|近く|親密に	anc
seriously	真面目に|本気に|深刻に|重く|まじめに|まじめな話だが|ひどく	anc
soap	せっけん|石鹸|を石鹸で洗う	anc
pollution	公害|汚すこと|汚染|汚れ	anc
leaf	葉	original
pointer	助言|アドバイス|指し示す人|指摘者|むち|猟犬	anc
remind	を思い出させる	anc
hazard	危険にさらす|危険|冒険|偶然|運|災害|障害|要因となるもの	anc
personality	個性|人物|人格|名士|人間であること|独特な雰囲気|テレビによくでる有名人	anc
chest	収納箱|胸郭|金庫|たんす|肺	anc
elsewhere	他の場所に|他のところで|他のどこかで	anc
effectiveness	有効	anc
abroad	外国で|外国へ	anc
urge	強く迫る|説得する	anc
ebony	(ほめて)漆黒の|真っ黒の|黒檀(こくたん)(の)	anc
tail	尾|尻尾|尾状のもの|後部|下っ端|に随行する|見張り|尾行|尾行者|見張りの者	anc
lifetime	生涯(の)|一生(の)	anc
grab	ひったくる|逮捕する|を横取りする|物をつかむ機械|わしづかみ|好意|猶予|気品	anc
hybrid	混成語|雑種|合いの子|ハイブリッド|混成物	anc
relate	関係がある|を関係づける|を述べる|話す	anc
vista	展望|眺望|ながめ|見通し|予想	anc
spare	スペア|貯え|手放す(to treat mercifully)|勘弁する|容赦する|出し惜しむ|を取っておく|を使わない	anc
tribe	部族|種族|一族	anc
partial	一部分の|不完全な|一部(分)の|不公平な|とても好きな	anc
beverage	飲料|飲み物	anc
farmer	農場主	anc
yoga	ヨガ|ヨガの行(瞑想的修行法)	anc
whereas	･･であるのに	anc
glad	うれしい	anc
copper	(軽蔑的に)警官|銅|銅板|銅器|銅製品|銅貨	anc
everybody	誰でも	anc
succeed	成功する|あとを継ぐ|続く|継承する	anc
treasure	大切にする|(思い出など)を取っておく|宝|財産|富|重要な物	anc
sublime	気高い|崇高な|雄大な|卓越した|高尚にする|浄化される|(化学)昇華する	anc
defend	防衛する|守る	anc
ordinary	普通の|ありふれた|直轄の	anc
acceptable	容認できる	anc
reception	receiveの名詞形|歓迎会|披露宴|聴取|応接|入会	anc
margin	利ざや|限界|余白|縁|余裕	anc
nobody	誰も(一人も)～ない|(特に地位や財産のない)とるに足りない人	anc
plaza	(スペイン語)(都市の)広場|プラザ|市場	anc
nova	ラテン語で新星の意味	anc
romantic	ロマンテックな人|伝奇物語的な|ロマンチックな|実際的でない|非現実的な	anc
wise	賢い|博識な|賢そうな|えらそうな|知らせる|教える	anc
stability	安定(性)	anc
southwest	南西(部)|南西の|南西へ	anc
axis	中心線|軸	anc
cherry	サクランボ|桜	anc
sole	唯一の|独占的な|独身の|足の裏|蹄鉄|シタビラメ|シタガレイ	anc
grass	芝生|草|牧草|牧草の種をまく|(俗)マリファナ|大麻	anc
institutional	組織的な	anc
stupid	愚かな|ばかな	anc
thermal	熱の|温度の|熱による|温泉の|暖かい	anc
metabolism	代謝|新陳代謝|物質交代	anc
independence	独立心|独立|自立|自活	anc
warrant	正当な理由となる|を保証する|に請け合う|令状|証明書	anc
harvest	収穫する|刈取る|報い|収穫|収穫高|収穫期|結果|取り入れる	anc
fragrance	芳香	anc
cloudy	雲の|曇った	anc
surround	を取り囲む|サラウンド	anc
diagram	図解	anc
personally	個人的に|自分自身で|直接に|自分としては	anc
acrobat	曲芸師	original
plenty	たくさん|豊富|多数|多量|豊富さ|十分に|たっぷり	anc
excellence	優秀|卓越|長所|美徳	anc
brass	真ちゅう|真鍮(色･製品)(の)|黄銅|ずうずうしさ|お偉方|大物	anc
cheat	をだます|ごまかす|浮気する|詐取|カンニング|だますこと|ごまかし|詐欺師|不正行為	anc
departure	新機軸|出発|発車|逸脱|背反|出航|門出|離脱	anc
lucky	幸運な	anc
wealth	豊富|富|裕福|財産	anc
somewhere	どこかに|ある時|何時か|およそ	anc
allocation	割り当て	anc
survival	生存(者)|生き残ること	anc
den	動物の住む穴|動物園の檻|住みか|書斎	anc
clerk	事務員	anc
acquire	を習得する|を獲得する	anc
binary	二進法の	anc
warrior	勇士|武人|武士|軍人	anc
celebration	祝賀|式典	anc
attendance	出席	anc
trans	超えて|横切って	anc
offset	分かれ|分派|オフセット(印刷)|埋め合わせ|相殺|相殺する	anc
whenever	ときはいつも|いつであろうと|時はいつでも|いつ～しようとも|いったいいつ	anc
resolve	疑問を解決する|に決心させる|決定させる|を決心する|を分解する|を解析する|を変化させる|決意|決断	anc
duke	公爵	anc
necklace	ネックレス|首飾り	anc
athletic	運動競技の	anc
integer	(ínṭɪdʒɚ)完全なもの|完全体|(数学)整数|整数値	anc
lovely	うっとりするほど|美しい|かわいらしい|楽しい|美しい女|美しいもの	anc
founder	倒れさせる|浸水する|失敗する	anc
monkey	サル|いたずら小僧|遊び回る|いじくる	anc
casual	さりげない|くだけた|偶然の|不用意の|のんきな|臨時の|略式の|即座の	anc
methodology	方法論	anc
vital	きわめて重大な|致命的な|生命の|生命維持に必要な|活気のある	anc
rebate	手数料|リベート	anc
nest	に巣をつくってやる|巣|巣を造る|隠れ場所|悪事の温床	anc
telling	手ごたえのある|有効な|(知らず知らず)感情(内情)を外に表わす|効果的な|話すこと|教えること|多くを語る	anc
steam	蒸気の|蒸気|水蒸気|スチーム|霧|もや|力	anc
fairly	相当に|公平に|正しく|かなり|完全に|全く	original
coastal	海岸の	anc
intelligent	知的な	anc
rick	積みわら	anc
regardless	かまわない|無頓着な|不注意な	anc
aluminum	アルミニウム(金属元素)	anc
approve	を承認する|賛成する|を気に入る	anc
loose	ゆるい|しまりのない|容器に入っていない|自由な|矢離れ|結末|成り行き|放つ	anc
deserve	を受けるに足る|に値する	anc
transformation	変換|変形|変化|変容|変質|変態|変圧	anc
advise	に忠告する|に助言する|通知する	anc
latter	後者|後の方の|近ごろの	anc
intermediate	中間にある|中間の|媒介物|仲裁人|中間体	anc
suspension	負債の返済不納|吊すこと|停止|宙吊り|未決定|停職	anc
mint	ハッカ(入りの菓子)|造幣局|多額|源泉|鋳造する|ま新しい|未使用の	anc
debug	除虫する|の欠陥を捜して直す|デバッグする|から盗聴器を取り除く	anc
stamp	スタンプ|商標|切手|を踏みつける|をスタンプで押す	anc
bookstore	書店	anc
defence	弁護|守り	anc
bra	ブラジャー	anc
lite	(=light)	anc
steer	舵を取る|操縦する|を案内する|向ける|進む|雄の子牛|去勢した雄牛	anc
announcement	発表|通知	anc
observer	オブザーバー|観察者|観測者|遵守者|立会人	anc
outcome	結果|成果	anc
passage	通過|通行|通路|旅行|一節|経過|通過帯域	anc
damn	強く非難する|呪う|呪い|ちぇっ|ちくしょう	anc
triple	3倍の|3重の|三重の|三種類の|三塁打	original
cassette	カセット	anc
jerry	肉体労働者|小型ピストル|安請負の|間に合わせの|貧弱な|室内便器|ハッと悟ること|よく分かっている	anc
gulf	湾|裂け目|大きな隔たり|深い割目|深い穴|深淵	anc
clay	粘土	anc
indoor	屋内|室内の	anc
shut	を閉める|を閉じる|閉まる|閉じた	anc
cite	引用する|列挙する|を引き合いに出す|特記する	anc
organ	オルガン|器官|機関|音声	anc
regularly	規則正しく|きちんと|正規に|まったく|正式に	anc
transcript	写し|複写|転写物|謄本	anc
bat	コウモリ|強打	anc
funeral	葬儀|葬式(の)|葬列|告別式	anc
cooling	冷却	anc
killer	殺し屋|殺す動物(器械)|殺人鬼	anc
opt	選択する	original
shopper	買物客|(商店の)広告ビラ|広告専用雑誌	anc
entrance	入口	anc
bull	乱暴なことをする|がっしりした男|頑固な|強気筋|雄牛|雄|ブルドック	anc
partly	部分的に|一部は|ある程度は|少しは|いくぶん	anc
steal	を盗む|盗み取る	anc
legacy	遺産|遺物|先祖伝来のもの|形見	anc
construct	組み立てる|建築する|構築する	anc
concentrate	集中する|集中させる	anc
telecom	電気通信	anc
span	紡いだ(ぐ)|期間|長さ|(橋が)～にかかっている	anc
invitation	招待状|招き|招待|案内|案内状	anc
ceramic	セラミック|製陶の|陶器の	anc
tobacco	たばこ|刻みたばこ|喫煙	anc
orientation	適応指導|方向(性)	anc
noble	堂々とした|気高い|堂々たる|高貴の|貴族の|崇高な	anc
creator	創造者|創作者|創設者|創始者	anc
stud	ちりばめる|びょう|埋め込みボルト|飾り釘|飾りボタン|プレーボーイ	anc
pepper	唐辛子|コショウ(をかける)|ピリッとさせる|(文章などを)引き締める	anc
marker	マーカー|マークする物|目印|採点者|記念碑	anc
execute	芸術品を創作する|果たす|実行する|演奏する|契約を履行する|死刑にする	anc
rose	バラ|淡赤色|美人|美貌|バラ色になる|riseの過去形	anc
governance	統治(組織)|支配(権)|管理(方式)|被支配状態	anc
defeat	を打ち負かす|beat|敗北|失敗	anc
chronic	慢性の|常習的な|長引く	anc
bachelor	独身の男性|独身の男|学士 	anc
trek	(長く苦しい)旅をする|小旅行|(特に難儀な)旅行	anc
pole	棒|柱|マスト|ポール|(性格･言動などの)正反対|両極端	anc
distribute	配送する|分配する|分布している	anc
preliminary	予備の|準備的な|仮の|前置きの|発端の|序の|下ごしらえ|予備試験	anc
glory	繁栄|栄光|誇り|壮観|荘厳	anc
elite	エリート(層)|精鋭|精粋|選ばれた人びと|選良	anc
bikini	ビキニ(水着)|ビキニ環礁(1946年から米国が核実験を行った)	anc
geography	地理学|地形	anc
optimize	最適化する|最も効果的にする	anc
arc	弧(こ)	anc
ourselves	我々自身で|の	anc
bow	(発音 bάʊ) おじぎ|おじぎをする|屈伏する|服従させる|へさき|船首|犬の鳴き声(bow-wow)|(発音 bóʊ)弓	anc
wooden	木製の|木でできた|不器用な|無表情な|ぎこちない	anc
analog	(=analogue主に英)|アナログ(の)|類似(の)|相似(の)|(肉･魚もどきの)合成食品	anc
cigarette	巻きタバコ	anc
adjust	(環境に)慣れる|を適合させる|調節してあわせる	anc
gonna	(俗)するつもりの(going to)	anc
bishop	ビショップ|司教|僧正	anc
precision	精密な|正確|精密|細心|几帳面さ	anc
silk	絹(の衣服)|絹の|やわらかな|ぜいたくな|絹糸|絹織物|(複数形で)絹の着物|(競馬の騎手の)制服	anc
gospel	ゴスペル(宗教音楽)|福音|福音書|信条	anc
afford	余裕がある|与える	anc
capability	将来性|能力|可能性|手腕	anc
reflection	反射|反映|熟考	anc
herself	彼女自身	anc
sad	悲しい	anc
soundtrack	録音帯|サウンドトラック(音楽)|サントラ･ミュージック|サントラ録音|映画音楽|サントラ版	anc
diesel	ディーゼル機関(船･車)	anc
diverse	別種の|多様な|多様性をもつ	anc
salon	サロン|(高級)店|客間|大広間	anc
compile	を編集する|(資料など)を集める|(財産など)を作り上げる	anc
nylon	ナイロン|ナイロンストッキング	anc
remedy	を治療する|医療|治療|療法|医薬|救済策	anc
ah	ああ!	anc
discrimination	人種差別|識別	anc
rehabilitation	社会復帰|名誉回復|復権|復興	anc
atlas	『地図帳』|図解|表解	ejdict
acoustic	電子機器を介さない|音響上の|聴覚の	anc
railway	鉄道|軽便(路面)軌道	anc
protest	異議の申し立て|に抗議する|抗議|異議|主張|言明|断言	anc
oven	オーブン	anc
assurance	保険|確かさ|確実さ|保証|請合い|言質|安定|安泰	anc
shelter	避難場所|避難所|保護|を保護する|避難する	anc
macro	マクロ	anc
ho	おーい|おいこら|ホーイ	anc
saver	貯める人|救助者	anc
blvd	大通り|ブールバード	anc
rev	エンジンを回転させる|回転	anc
mood	気分|気持ち|憂うつ|雰囲気|法	anc
engagement	約束|婚約	anc
correctly	正しく	anc
sauce	面白味|興趣を添えるもの|生意気(な言葉)|ソース|果物のシチュー煮|果物の砂糖煮|味を添えるもの	anc
photograph	写真|を写真にとる	anc
marc	絞りかす|マール	anc
overnight	夜通し|一晩中|前夜の|一夜のうちに	anc
theft	盗み|窃盗罪|窃盗(罪)|盗塁	anc
pray	祈る	anc
drag	を引く|畑をならす|だらだら進む	anc
integrity	正直|誠実|完全性|整合性	anc
buck	(俗)ドル|金|雄鹿|押す|がんこに抵抗する|木びき台|鋸(のこぎり)でひく	anc
dimension	容積|寸法|面積|次元	anc
crap	無意味な|価値のない物|がらくた|たわごと	anc
paradise	楽園|天国|地上の楽園|至福	anc
fence	柵|盗品買受け人|盗品買人|(野球)フェンス	anc
detect	検出する|発見する|見破る|検波する	anc
tender	差し向ける|を提出する|を申し出る|入札する|支払う|気を使う|柔らかい|もろい|虚弱な|感じやすい|提供|(機関車の)炭水車	anc
widely	広く|大きく	anc
lat	緯度(latitude)|おもり|釣り合い	anc
genuine	本物の|純種の|純粋の|心からの|真の|誠実な	anc
cemetery	共同墓地	anc
functionality	機能性	anc
refuse	を断る|辞退する	anc
emotional	感情の|感動的な|感情的な|興奮した	anc
isle	小島	anc
pendant	ペンダント|つりランプ|シャンデリア|吊り輪|対の一方	anc
bandwidth	帯域幅(通信用語)	anc
versus	対|(訴訟･運動競技で)A対B|と対比して	anc
lung	人工呼吸装置|肺	anc
coalition	(一時的な)連合|連立|一体化	anc
geographic	地質学上の	anc
juice	ジュース	anc
migration	移住|移住者の群れ	anc
negotiate	(条約締結など)交渉する|協定する|取り決める	anc
profession	専門的職業|職業(医師|弁護士など知的な専門職)	anc
promotional	昇進の	anc
disorder	無秩序|混乱|不調|乱雑|不規則|の秩序を乱す	anc
dawn	夜明け(daybreak)|黎明|夜が明ける|暁|明るくなる|発達しはじめる|分かり始める	anc
blast	爆発(させる)|スリル|楽しい時間|突風|非難(する)|台なしにする|枯らす|explosion	anc
machinery	(集合的に用いて)機械類|機械装置|機構	anc
jimmy	(食用の)羊の頭|(強盗用の)金てこ|金てこでこじあける	anc
dig	探求する|を探し出す|深く研究する|気にいる|掘る|土を掘る	anc
reed	屋根のふきわら|ヨシ|アシ(の茂み)|リード楽器	anc
authentication	立証|認証|特定情報へのアクセスの際|端末装置や個人を識別検証すること	anc
vulnerability	傷つきやすいこと|脆弱性	anc
specialist	スペシャリスト|専門家|専門的な	anc
observe	観測する|述べる|守る	anc
proportion	比率|割合|釣り合い|調和|分け前|釣り合わせる	anc
bicycle	自転車	anc
correction	修正相場|訂正	anc
slowly	ゆっくりと	anc
rugby	ラグビー	anc
gnome	(ギリシャ神話)ノーム(地の精)|しなびた老人|投機的銀行家	anc
demonstration	デモ|実証|実演	anc
admit	(いやなこと)を認める|に入ることを許す	anc
cal	カロリー|calorie	anc
propose	提案する|申し込む	anc
rip	激流|を詮索する|はぎ取る|引き裂く|切り取る|(話)やくざ馬(者)|がらくた|波浪の激しい水域	anc
ta	ありがとう(英略式)	anc
unlike	〜とは違った	original
technician	専門家|技術家	anc
regime	政治制度|政権|制度|政体|体制	anc
cooper	おけ屋	anc
pi	(第16ｷﾞﾘｼｱ文字)パイ|π|Π 2|(数)円周率	anc
praise	をほめる|ほめること|賞賛	anc
quarterly	年4回の|季刊誌	anc
punk	パンクファッション(の人)|くだらぬもの|たわごと	anc
convenience	便利なもの|都合|便利	anc
enrollment	登録|入学	anc
pill	丸薬|経口避妊薬|不愉快な人|弾丸|苦しいこと	anc
sunset	夕焼け空|日没|終局	anc
continental	大陸の	anc
scroll	スクロールする|巻き物|渦巻模様	anc
herald	告知する|予告する|報道者|先駆者|先触れ	anc
directive	指令する	anc
rpm	revolutions per minute毎分回転数	ejdict
dialogue	(UK英語|US英語はdialog)対話	anc
flexibility	柔軟性|屈折率	anc
dive	飛び込む	anc
silent	沈黙した|静かな|無言の	anc
skate	(アイス)スケートをする|(アイス)スケート靴|(魚)ガンギエイ	anc
childhood	幼児期	anc
prediction	予言|予想|予測|予報	anc
lottery	めぐり合わせ|宝くじ|抽選|運	anc
bundle	大金|包み|束|固まり|大量|小包	anc
convenient	便利な	anc
soup	スープ	anc
fake	ごまかし|いかさま|のふりをする|仮病を使う|ねつ造する|だます	original
pal	仲良し|友人|友達|相棒|おい(呼びかけ)|仲良しになる|仲良く付き合う	anc
wisdom	知恵|賢明|賢人|分別	anc
gauge	標準寸法|規格|尺度|計器|レールの軌間(ゲージ)|判断基準|測る	original
literary	文学に通じた|文学の|文芸の	anc
reset	リセットする	anc
knee	ひざ|膝|膝で押す(突く)	anc
threshold	敷居|発端|始め|出発点|入り口	anc
diameter	直径|倍率	anc
corn	トウモロコシ|穀粒|穀草|魚の目	anc
meta	(ギリシア語)meta- 超等の意味の接頭語	original
payday	給料日|決算日	anc
injection	注射	anc
starter	開始者|始動機|始める人(物)|スタート係|競争に出る人|セルモーター(和製英語)	anc
donor	寄贈者|臓器提供者|開発援助供与国	anc
mold	形作る|(に基づいて)作る|土|沃土|肥土|型|鋳型|流し型|骨組み|鋳物|性質|カビ	anc
quit	をやめる|give up|stop	anc
highland	台地|高地|高原	anc
restoration	復旧|返却|復興|回復|返還	anc
impression	気持ち|印象|感動|感銘|影響|結果|感じ	anc
bias	バイアス|傾向|偏向|心の傾向|先入主|偏見	anc
investigator	調査員	anc
sur	シュール|超越した|現実離れした	anc
automation	オートメーション	anc
harm	を害する|害|傷つける|損害|悪意	anc
trunk	トランク|主要な|(木の)幹･胴体|幹線|長距離電話|(象の)鼻	anc
cooperative	協同組合の|協力の|共同～	anc
bibliography	参考文献|文献目録	anc
median	中央の|正中の|メジアン|中点	anc
robin	コマドリ	anc
confirmation	売買報告書|確認	anc
suppose	仮定する|だと思う|だと想像する|もし～だとしたら	anc
orchestra	オーケストラ|管弦楽団	anc
intro	紹介(する)|イントロ|序|序奏	anc
detector	発見者	anc
zoo	動物園	anc
ceiling	天井|最高価格|最高限度	anc
athletics	アスレチック|運動競技	anc
beaver	ビーバー	anc
southeast	南東|南東部地方|南東に|南東から	anc
opposite	反対側の|逆の|向かい合っている|〜の向こう側に	original
destruction	破壊|破滅	anc
corp	法人|corporation	anc
fool	ばか	anc
collective	全体的な|共同の|集団の	anc
sh	しー!	anc
constitute	構成する|制定する|の構成要素となる	anc
cow	雌牛|乳牛|おびやかす|(intoを伴って)脅してさせる	anc
bubble	泡(立てる･立つ)|実態のないもの|みせかけ	original
decor	(仏語)装飾|舞台装置	anc
unusual	異常な|一風変わった|珍しい|見かけない	anc
horny	角状の|角質の|発情した|ムラムラする	anc
spouse	配偶者	anc
commodity	生活必需品|商品|必需品|日用品|有用品|物資	anc
increasingly	ますます|more and more	anc
subsidiary	子会社|補助的な|従属的な|付随する|支援する	anc
basically	基本的に|根本的に	anc
conventional	伝統的な|習慣的な|形式的な|きまりきった|協定上の	anc
piss	小便(をする|婉曲にはpee)|go on the piss大酒を飲む|(itを主語にし)どしゃ降りである|piss away浪費する|(他)piss off怒らせる|(嫌悪)ちくしょう	anc
toilet	化粧|便所|便器|洗浄|トイレ	anc
pierce	ピアスをする|を刺す|を貫く|に穴を開ける|突き進む	anc
renew	を新しくする|を再び始める|を更新する|を再び満たす	anc
fortune	社会的地位|富|財産|運|運勢|運命|幸運	anc
canyon	峡谷	anc
terror	(非常な)恐怖|恐ろしさ|恐怖の種|テロ	anc
pie	パイ(食べ物)|総額|楽なこと|カササギ	original
herein	この中に|ここに	anc
occupational	職業の	anc
programmer	プログラマー	anc
judicial	裁判の	anc
dump	ドシンと落とす|商品を投げ売りする|出力する|(恋人を)振る|ゴミ捨て場|dump truckダンプカー	anc
fame	名声	anc
horn	角製のもの|角|角で突く|触覚|警笛|ホーン	anc
opposition	反対|対立|抵抗	anc
duck	アヒル(おしゃべり･あざむきの象徴)|かわいい人|ひょいと頭を引っ込める|かわす	anc
criticism	批判|非難|批評	anc
tunnel	トンネル|地下道|坑道|穴|巣	anc
genetics	遺伝学|遺伝子	anc
shipment	積出し|発送(品)|船積み(荷)|積み荷	anc
rough	手触りの荒いもの|でこぼこの|ざらざらした|毛深い|荒れた|未加工の|乱暴者|スケッチ|下書き	anc
manufacture	を製造する|生産する|製造|生産|製品	anc
artwork	イラスト|さし絵|図版|手工芸品など	anc
basin	洗面台|たらい|洗面器	anc
besides	〜の他にも	original
township	郡区|町区	anc
pond	池|泉水|沼	anc
collapse	失敗(する)|崩壊(する)|暴落(する)|衰弱(する)	anc
quantum	量子	original
parish	教区(民)|郡|巡回区域|専門分野	anc
grip	掴む|握力|握りかた|グリップ|支配(力)|理解力	anc
observation	観察|所見|監視|観測|言葉|注目|発言	anc
rabbit	ウサギ	original
deny	を否定する|を拒否する	anc
doll	人形	anc
disposal	支配権|配置|配列|処理|売却	anc
thesis	論文|主張|議題|論題|題目|卒業論文|命題	anc
entrepreneur	起業家|企業家|事業主|興行主|請負人|仲介者	anc
anchor	錨|しんがり|定着させる|固定させる	anc
yr	yearの略語	anc
documentary	ドキュメンタリー|文書の|ドキュメンタリー映画|事実を記録した|記録もの	anc
inkjet	インクジェット	anc
knit	編んだ|組む|編む	original
verification	検証|査察	anc
corps	軍団|部隊|兵団	anc
coal	石炭	anc
aside	側に|別に	original
literacy	教育のあること|読み書き能力	anc
pose	姿勢(ポーズ)をとる|気取る|のふりをする|(問題など)を提示する|姿勢|気取った態度|気構え	anc
liable	責任を負うべき|義務である|法的責任のある|しがちな	anc
assault	襲う(こと)|襲撃|突撃|暴行(未遂)|非難する(こと)	anc
withdraw	取り消す|撤退する|回収する|を退場させる|閉じこもる	anc
carol	賛美歌|喜びの歌|キャロル	anc
layer	置く|層にしておく|層|積み重ね	anc
merge	合併する|合同する|同化吸収する|溶け込ませる|融合する	anc
relay	新材料の供給|交替者|新手|換え馬|リレー	anc
shine	光らせる|輝く|を磨く|光|cancel|blow off	anc
tin	スズ|ブリキ|すず製容器他	original
odd	奇数の|余りの|～余り|残りの|時々の|片方の|半端な|妙な|変な	anc
proxy	代理(権, 人)|委任状|代用となるもの	original
juvenile	少年少女(向き)の|若い|少年の|少女の	anc
composer	作曲家	anc
tit	乳房	anc
texture	織り目|構成|生地	anc
rainbow	虹	anc
perception	知覚|認識	anc
stadium	スタジアム|競技場	anc
fork	フォーク|分岐点	anc
employ	を雇う|(方法･言葉など)を用いる|use	anc
redeem	義務を果たす|を取り戻す|を買い戻す	anc
fry	油で揚げる|電気椅子で処刑する|稚魚|(集合的)小さいもの(子ども･小動物)	anc
attraction	魅力|引きつけるもの	anc
bore	うんざりさせる|退屈なもの(人)|bear(産む)の過去形|掘る	original
blame	を非難する|のせいにする|非難|責任	anc
cricket	コオロギ	anc
balloon	風船|ふくらむ	anc
nose	鼻	original
involve	人を巻き込む|を含む|必要とする|意味する	anc
chef	コック長	anc
ash	灰|トネリコ(材)	anc
weird	超自然的な|奇妙な|風変わりな|変な|不思議な|運命の	anc
vast	広大な|巨大な|莫大な|巨額の	anc
rapidly	急速に|速く|急いで	anc
scout	スカウトする|捜す|斥候|スカウト	anc
disclose	暴露する	anc
metropolitan	首都の|首都の住民|大都市の人	original
interact	互いに作用･影響しあう	anc
condo	分譲マンション	anc
intent	一心に向けた	anc
exploit	開発する|搾取する	anc
sigma	(第18ギリシア文字)シグマ|Σ|σ	anc
showcase	模範|モデル|見本|陳列棚	anc
exploration	探検|探求	anc
combo	コンボ(小編成のジャズバンド)	anc
tenant	借家人|借地人|居住者	anc
benchmark	(価値判断などの)基準|水準点|基準テストにかける	anc
textile	織物(の)|編み物(の)	anc
membrane	薄膜|膜|皮膜|膜組織	anc
ceremony	宗教儀式|儀式|式典|礼儀|作法	anc
attractive	魅力的な	anc
aggregate	集まった|骨材|集合|集める|統合する|総計～となる	anc
electron	電子|宇宙を構成するレプトンに分類される素粒子|記号はe−で表される	anc
recording	レコーディング|収録|録音|記録する|自動記録仕掛の	anc
bee	ハチ|ミツバチ|働き者|(仕事, 娯楽の)会合|集まり	original
victim	犠牲|犠牲者|いけにえ|詐欺にかかった人|被災者	anc
semiconductor	半導体	anc
beef	牛肉|問題|不満	anc
careful	注意深い	anc
fleet	速い|艦隊|海軍|入江	anc
commander	指揮者|海軍中佐	anc
bite	刺激する|刺す|噛む|かみ切る	anc
intention	ねらい|意図|意志|概念	anc
mentor	よき助言者|相談相手|よき指導者	anc
spider	(動物)クモ|三脚台|フライパン	anc
undertake	引き受ける|約束する|保証する|企てる	anc
sword	武力|剣|刀|暴力|戦争	anc
gel	ゲル|膠(こう)化体	original
treaty	協定|条約(国家･政府間で締結される合意)|約束	anc
burden	責任|負担|義務|荷|心配|重荷|積載力|荷物はこび|(重)荷を負わす	anc
moreover	その上|なおその上に	anc
amend	修正する|改める	anc
tongue	演奏する|を舌で触る|なめる|舌|言葉|言語能力|言葉使い|国語	anc
suicide	自殺(する)|自殺者	anc
minimal	最小の|最小	anc
essay	随筆	anc
polyphonic	(音楽で)対位法の|多声的な	ejdict
adjustable	調整できる	anc
thou	なんじは|そなたは	anc
conclude	と結論づける|を終わりにする|しめくくる	anc
gym	屋内体操場|体育館|体操|体育	anc
ranch	大牧場|農場|農園	anc
fisher	漁師|フィッシャーテン(の毛皮)	anc
tear	涙|引き裂く|tore(過去形), torn(過去分詞)	original
threesome	スリーサム(1対2の対戦)|3人組み	anc
composite	混成の|合成の	anc
alphabetical	アルファベットの	anc
camel	ラクダ|駱駝	anc
rally	再び集める|元気づける|回復(する)|反騰(する)|大会|集会	anc
bride	花嫁|新婦	anc
handheld	片手で持てる|携帯できる	anc
tracker	獲物を追う猟師|警察犬|追跡者|砲撃目標追跡装置|引き船|船引き人	anc
complexity	複雑さ	anc
fare	料金|運賃|旅をする|暮らす|ごちそう	anc
midnight	真夜中|真夜中の	anc
voluntary	自発的な|自由意志による|有志の|無償の	anc
greatly	大いに|偉大に	anc
partition	区画|分割|分配|区分|分離|を分割する	anc
compatibility	適合性|一致	anc
commonly	一般に|通例|下品に|粗野に|通俗に|普通	anc
pleasant	心地よい|楽しい|愉快な|好ましい|晴れて心地好い	anc
syndicate	シンジケート|犯罪組織|通信社|をシンジケート組織にする|企業連合	anc
exhaust	体力を使いつくす|仕事で疲れ切る|排出する|中身を空にする|水を排出する|排気|消耗	anc
roommate	ルームメート|同室者	anc
toner	インクトナー	anc
scratch	スクラッチする|ひっかくこと|ひっかく|傷をつける|ひっかき傷	original
grocery	食料雑貨類|食料雑貨店	anc
potato	じゃがいも	anc
largely	主として|大部分|大いに	anc
rap	ノックする|こつんとたたく(こと)|(特に新聞の)非難|攻撃(する)|雑談|criticize|ラップ音楽(リズミカルに喋るように歌う方法)	anc
cad	育ちの悪い男|ごろつき|不良|手伝いの人|地元の人|町の少年	anc
snap	急な|即座の|パチン(と音をさせる)|ぽきんと折(れ)る|パクッ(とかみつく)|鋭い口調で言う|写真を撮る	anc
inspector	工事監督者	anc
sampling	サンプリング抽出	anc
dam	せき止める|ダム	anc
flavor	風味|趣き|味	anc
oxygen	酸素|元素記号O	anc
reputation	名声|世評|評判|好評	anc
bitch	雌犬|(卑語)淫乱な女|意地悪で不愉快で身勝手な女|不平･不満を言う	anc
wedding	結婚式|結婚記念日|融合|結婚(式)	anc
lawn	芝生	anc
suddenly	突然に	anc
cookie	クッキー(焼き菓子)(俗)やつ|魅力的な女	original
merely	ただ|たかが～に過ぎない|ただ～だけの|単に	anc
magnet	磁石|引付ける物	anc
arrangement	準備|整理|配列|取り決め	anc
cowboy	カウボーイ|牛飼い|(協定労働条件を破って働く)未組織労働者	anc
swap	交換(する)	anc
tattoo	帰営らっぱ(太鼓)|ドンドン(コツコツ)たたき続ける音|入れ墨(をする)|彫り物	anc
furthermore	その上|なおその上に	anc
pit	くぼみ|穴|立坑|平土間(の観客)|囲い|に穴を作る	anc
bench	ベンチ|法廷|裁判官	anc
jury	審査員団|陪審|陪審員団	anc
ranking	ランキング	anc
tumor	腫瘍|膨らみ|出っ張り	anc
invoice	インボイス|送り状	anc
puppy	子犬	anc
roulette	(仏語)ルーレット	anc
possess	を所有している	anc
nomination	(特に官職の)任命|指名|指定|推薦	anc
justify	正しいとする|正当化する	anc
depend	依存する|次第で決まる|(文法)従属する	anc
ruby	ルビー|ルビー色の|紅玉(7月の誕生石)|深紅色|赤ぶどう酒|真紅の|ルビ(振り仮名用の活字)	original
minimize	最小限にする|軽視する	anc
medicare	高齢者向け医療保険制度	original
workforce	(作業)要員|総労働力|労働|労働人口	anc
spotlight	スポットライト	anc
payable	採算のとれる|支払うべき|支払うことのできる|支払満期の|もうかる	anc
ferry	渡し場|フェリーボート|自力現地輸送する	anc
opponent	反対者|対抗者|敵|反対する|敵対する	anc
delight	大喜びする|喜び|楽しみ|歓喜|楽しませる	anc
tent	テント	anc
renewal	更改	anc
salad	サラダ	anc
shelf	棚|たな|棚の上のもの|棚状のもの	anc
floral	花の	anc
pig	ブタ(swineより家畜的な意味)|豚肉|ブタのようなやつ|あばずれ女|金属塊|子を生む	anc
runner	密輸業者|競争者|走る人|集金人|運転者|羽根車|つる|(靴下の)伝線|客引き|カーペット	anc
weigh	(重さを)量る|重荷になる|出航する|よく考える|重要である	anc
legislature	立法府	anc
commonwealth	国民|国家|共和国|民主国家	original
incredible	信用出来ない|うそのような|途方もない|驚くべき|信じられない	anc
cabin	キャビン|小屋|船室	anc
haven	(避難)港|停泊所|安息所|避難所	anc
donation	寄付	anc
hormone	ホルモン	anc
slim	ほっそりした|わずかな|薄っぺらな|やせる|やせさせる	anc
bunch	仲間|一団|群|(果物などの)房	anc
inclusion	包含	anc
accent	アクセント|口調|なまり	anc
fellowship	友情|仲間	anc
ghz	ギガヘルツ	anc
organizational	組織的な	anc
canvas	研究調査する|遊説してまわる|選挙運動をする|カンバス|キャンバス|テント|麻布|帆布|ズック	anc
amber	琥珀色|琥珀|琥珀色(こはく)色|黄色	anc
adverse	不利な|反対の	anc
everywhere	どこでも	anc
acute	鋭い|激しい|緊急の|急性の|ひどい|重大な	anc
somebody	だれか|重要人物|大物|ひとかどの人物	anc
digit	(おどけて)(人･動物の)指|アラビア数字|(数字の)桁	anc
verse	詞|詩の一行|韻文|詩句|詩歌|詩を作る	anc
envelope	包装材料|封筒|包むもの	anc
chi	(第22ギリシア文字)カイ|Χ|χ	anc
honest	素直な|ホントさ･ウソじゃないよ|正直な|正当な	anc
hazardous	冒険的な|危険な|きわどい	anc
tub	おけ|たらい|浴槽|入浴|～を桶に入れる	anc
housewares	家庭用品	ejdict
reload	再装填|再装填する|再びに荷を積む|再びに弾丸を込める|積み替える|補充する|リロードする	anc
resistant	抵抗力のある	anc
lean	もたれる|曲げる|かがむ|(～に)傾く|頼る|収穫の少ない|やせた|やせている|乏しい|やせた部分|赤身の	anc
antibody	免疫体|抗体	anc
locator	賃貸人|権利者|位置を示すもの	original
courtesy	礼儀正しさ|礼儀	anc
attach	くっつける|付属させる	anc
drain	排水|流れる|富を使い果たす|を飲み干す|を徐々に排出させる	anc
symposium	シンポジウム	anc
fusion	核融合|融解|融合|溶融|合併|連合|統合	original
fulfill	遂行する|fulfill(米語)|fulfil(英)	anc
phenomenon	現象|驚くべき物(事)|(複数形phenomena)	original
companion	対の片方|仲間|相手|伴侶|話し相手|気の合った友	anc
grave	刻みつける|重大な|厳粛な|くすんだ|墓穴|墓所	anc
survivor	生き残った人|生存者|遺族|遺物|測量士|検査官|鑑定士	anc
wrestling	レスリング	anc
coin	鋳造する|貨幣|小銭	anc
photoshop	フォトショップ	anc
possession	所有|所持|占有|所有権|財産|領地	anc
retrieve	検索する|引き出す|取り戻す|償う|回収する|回復する	anc
mathematical	数学的|数学(上)の|全く正確な|非常に正確な	anc
logical	道理にかなった|論理的な|当然な|論理学の	anc
authorization	権限の委任|承認	anc
medal	メダル|勲章|記章|メダルを授与する	anc
butterfly	蝶|チョウ|バタフライ(水泳)	anc
frequent	しばしば起こる|多い|頻繁な|たびたびの	anc
offense	違反|罪･攻撃|侮辱|立腹|不快なもの	anc
alias	別名|偽名|別名は|またの名|～こと	anc
horizon	地平線|水平線|視野|展望	anc
confidential	信用のできる|機密の	anc
statutory	法令の|法定の	anc
align	並べる|一直線にする|提携させる|一列に並べる	anc
northeast	北東部|北東へ|北東|北東の	anc
metric	メートルの|メートル法の|測定基準|距離関数|韻律学	anc
painting	塗る|絵(を描くこと)|画法|ペンキを塗ること|塗装|水彩画|油絵	anc
assign	を割り当てる|指定する|任命する|当てがう	anc
bullet	弾丸	anc
cloth	ラシャ|布|織物|布地|幕|服地	anc
testimony	証言|証明|立証|証明書	anc
fa	ファ(長音階第4音)	anc
deployment	展開	anc
termination	終了|接尾辞	anc
hawk	タカ|鷹|タカ派|強硬論者|他人を食い物にする人	anc
neutral	えこひいきしない|中立の|はっきりしない|中立者|ニュートラル|灰色っぽい	anc
flip	はじく|軽く打つ|弾く|ポンと打つ|宙返り|(アザラシ等の)ひれ足	anc
protective	保護の|保護用の	anc
slope	傾斜する|坂|傾斜(する)|に勾配をつける	anc
afraid	心配して|怖がって	anc
royalty	王室の人々|王族|王の身分|王位|王権|荘厳|著作権使用料|管轄権|採掘権|印税	anc
initially	初めに|はじめ(のうち)は	anc
indicator	メーター|指示薬|ウィンカー|方向指示灯	anc
queue	行列して待つ|待行列|列|おさげ髪	original
cave	陥没する|ほら穴|横穴を掘る	anc
priest	聖職者|司祭|祭司|奉仕者	anc
geek	(生きたヘビや鶏の首を食いちぎってみせる)奇態な見せ物師|(俗)変態|異常者|酔っぱらい	anc
sunglasses	サングラス	ejdict
preference	好み|好物	anc
heel	のすぐ後に続く|かかと|かかと状のもの	anc
compression	圧縮	anc
separation	分離|離脱|分類	anc
railroad	鉄道	anc
flu	インフルエンザ	anc
coupon	クーポン|回数券|利札	anc
reject	(提案など)を断る|拒絶する|turn down	anc
activation	アクティベーション|活性化	anc
ribbon	インクリボン|リボン|飾りひも|ひも状のもの	anc
astronomy	天文学	anc
complain	苦情を言う|不満を言う	anc
litigation	訴訟|起訴	anc
paste	をのりではる|ねり物|ペースト|のり|練り粉	anc
spice	スパイス|香辛料|薬味|趣|に香辛料を加える	anc
bracket	ひとまとめにする|括弧でくくる|腕木|腕金|張出し棚受け|電灯受け	anc
abortion	人工中絶|堕胎|流産|早産|(器官の)発育不全	anc
amplifier	増幅器	anc
mixture	混合体|混合物|混合|交錯	anc
comp	植字工|伴奏(者)|無料招待客|植字工として働く|の伴奏をする|組む|無料招待にする	anc
burner	バーナー	anc
poet	詩人|歌人	anc
spectacular	見ものの|見せ物の|壮観な|あっといわせる|はなばなしい|豪華ショー	anc
seasonal	季節の	anc
junction	連絡駅|連結|接合(部)|ジャンクション|はね橋|接合器|接点|多重ノード	anc
constitutional	保健のための|構成上の|体格の|体質の|生まれつきの|憲法上の|合法的な	anc
mobility	流動性|機動力|機動性|移動性	anc
perfectly	完全に|申し分なく|まったく	anc
borrow	を借りる	anc
instantly	ただちに	anc
gen	generalの省略形	original
horizontal	地平線の|水平の	original
gem	宝石|逸品|珠玉|〜を飾る	original
unlock	の錠をあける|を開く|打ち明ける|鍵が開く	anc
breath	息|呼吸	anc
volt	ボルト(電圧の単位)	anc
ordinance	法令|布告|儀式|しきたり|条例	anc
galaxy	(銀河系外の)星雲|(貴人･美人などの)華やかな集まり	anc
olive	(色)オリーブ|薄緑色|オリーブ色|薄緑	anc
informational	情報の	anc
ethical	倫理の	anc
friendship	友情	anc
organizer	組織者|創立委員|世話人|まとめ役|(興行などの)主催者|(労働組合などの)オルグ	anc
coordination	(文法)同格関係	anc
pickup	集めること|便乗者|かりそめの知り合い|好転|実況放送|間に合わせの	anc
prospective	見込みのあった|将来の|期待される	anc
freeze	凍る|凍らせる|氷結→凍ったようにピタッと動きを止める	anc
ultimately	最後に|ついに|最終的に|究極に	anc
predict	を予言する|を予報する	anc
procurement	斡旋|獲得|入手|周旋|達成	anc
equally	同等に	anc
artificial	人工の|不自然な|模造の|人為的な|人造の|人工的な	anc
intend	(～する)つもりだ|意図する	anc
turner	とんぼ返りをする人|フライ返し	anc
herbal	ハーブの|(薬)草の|草本の|植物標本集	anc
arrest	逮捕する|引き止める|阻止する|逮捕(=apprehend)	anc
guilty	罪の意識がある|有罪の|罪を犯した|犯罪的な	anc
passport	パスポート|旅券	anc
smell	匂いがする|を匂う|香り|匂い	anc
scream	鋭い叫び声をあげる|叫び|悲鳴をあげる|金切り声をだす	anc
naturally	生まれつきに|自然(天然)に|生来|もちろん	anc
strand	座礁する(させる)|岸に上がる|立ち往生する|取り残す(される)|より糸|房	anc
underwear	下着|はだ着	anc
overcome	に打ち勝つ|を克服する|(受け身で)参っている	anc
cod	タラ|鱈	anc
rocket	のろしを上げる|暴騰する|ロケット|ロケット弾|のろし|打ち上げ花火	anc
joke	からかい|冗談	anc
violent	乱暴な|強烈な|暴力的な|暴力による|こじつけの	anc
honey	はちみつ	anc
potentially	潜在的に	anc
mag	雑誌|(マグカップはmug)	anc
inclusive	包括的な	anc
dimensional	次元の	anc
considerable	少なくない|かなりの|相当の|重要な	anc
compiler	コンパイラー|編集者|編者|編纂者	anc
byte	情報量の単位|1バイトは2進数の8桁|即ち8ビット(bit)を意味する	anc
latex	乳液|ラテックス	anc
surgeon	外科医|(海軍の)軍医|船医	anc
anymore	(否定･疑問･条件節で)もはや|これ以上	anc
holding	続く|保有の	anc
sender	送り手	anc
bronze	青銅|ブロンズ	anc
rebuild	再建する	anc
bust	(女性の)胸部|破裂させる|破産させる|追っ払う|飲みすぎ|強打|失敗	anc
quilt	掛け布団|キルト|キルトを編む	anc
pantyhose	パンティストッキング	anc
snowboard	スノーボード	anc
cookbook	料理の本|詳しい解説書	anc
therapeutic	治療の|療法の|心の健康に良い	anc
airfare	航空運賃	anc
mart	市場|商業中心地|競売室	anc
velocity	速さ|速力|速度|迅速さ	anc
sculpture	彫刻をする|彫刻する|彫刻|彫刻作品	anc
addiction	熱中すること|夢中になること|-中毒	anc
constantly	絶えず	anc
nursery	子ども部屋|育児室|苗床|養成所|(悪の)温床|託児所	anc
microwave	マイクロウェーブ|電子レンジ	anc
presidential	大統領の	anc
rocky	ふらふらの|グロッキーの|岩のような|頑固な	original
dock	ドックに入れる|ドッキングする|(植物)スカンポの類	anc
thru	(米略式)through	anc
vaccine	ワクチン(の)|痘苗(の)	anc
loud	大声の|大声で	anc
divide	割る|分割する	original
lobby	ロビーに出入りする|議員に働きかける|の通過運動をする|圧力団体|ロビー|大廊下	anc
frog	カエル|フランス人	anc
silence	沈黙|静けさ|黙祷|を沈黙させる|を静める	anc
hospitality	親切なもてなし|歓待|心優しい	anc
anybody	だれでも|全ての人|誰か	anc
untitled	無題(の)	anc
prerequisite	前提条件の|必須の|あらかじめ必要な|必須要件|前提条件	anc
enforce	押しつける|実行する|執行する|を強制する|強化する	anc
plaintiff	原告|起訴人|民事訴訟の原告	anc
surveillance	(容疑者や敵の)監視|見張り|見渡す|調査する|監督	anc
theoretical	理論的な	anc
civilian	一般市民の|一般人|文民の	anc
genealogy	系図(学)|家系|血筋|系統|系譜|血統|系統学	anc
tray	盆|受け皿|料理をもった皿	anc
exotic	異国(風)の|外国(産)の|外来の|異国情緒の|風変わりな|魅惑的な|外来の物|外人(ｲｸﾞザﾃｨｯｸ)	anc
omega	(第24ギリシア文字)オメガ|Ω|ω|最後(のもの)	anc
optimal	最良の|最適の	anc
distinct	はっきりした|全く異なる	anc
brilliant	きらきら輝く|すばらしい|才気のある|きらめく|みごとな|立派な	anc
arrange	手はずを整える|手配する|を配列する|整理する	anc
brick	れんがを敷く|れんが	anc
enzyme	酵素	original
myth	作り事|神話|誤った社会通念|根拠のない説	anc
knock	たたく(音)|酷評する|トントン叩く|強打する|(野球)ノック	anc
hopefully	希望をもって	anc
helmet	ヘルメット	anc
raid	急襲(する)|引き抜き|襲撃(する)|侵略|奇襲|手入れ|かき乱す|attack	anc
accommodate	便宜を計る|親切にする|に金を融通する|供給する|適応させる|和解させる	anc
snake	陰険な人|くねる|ヘビ|くねって歩く|をくねらせる	anc
macintosh	=mackintosh	ejdict
civic	市民の|市の	anc
correspondence	文通|通信|交通	anc
turbo	turbochargerターボチャージャー|内燃機関の熱効率を高めるために利用される過給機の一方式	anc
dialog	(UK英)dialogue|対話|問答	original
punch	に穴をあける|を殴る|一撃|パンチ|穴開け器|穿孔機	anc
thereof	その|それの	anc
pillow	枕|まくら(をする)	anc
rebel	謀反|反逆者|謀反を起こす|調和しない	original
consist	構成されている|存在する	anc
intensity	緊張|強烈にする	anc
dale	(広い)谷|盆地|人名	anc
repository	貯蔵所|倉庫|納骨堂|埋葬所|(知識などの)宝庫	anc
traveller	旅行者|(US英)traveler	original
comparative	匹敵する|比較の|(文法)比較級	anc
reunion	再結合|再会|親睦(しんぼく)会	anc
authentic	信頼できる|信憑性のある|本物の	anc
wanna	したい|(=want to 口語)	anc
architectural	建築の|建築学の	anc
rim	リム|へり|枠|ふち	anc
invention	発明品|発明|創案|考案	anc
dare	あえて～する|に立ち向かう|挑戦|あえてすること	anc
closure	締切り|閉店|閉鎖|締め切り	anc
virtually	事実上|実質的には	anc
maple	カエデ|楓	anc
tale	物語|話|作り話	anc
depot	バス停|空港|倉庫|貯蔵物|補給所	anc
formerly	以前は	anc
deviant	外れた|逸脱した|変質者	anc
strictly	厳密に(言えば)|厳しく|きっちりと	anc
psychological	心理的|心理学の|心理学的な|精神的な|心理的な	anc
mason	石工|石で建てる|れんが職人	anc
slice	ひと切れ|一枚|を薄く切る|薄切り1枚|部分|を薄く1枚切り取る	anc
emphasize	を強調する	anc
tutor	家庭教師|個人指導教授|に教える	anc
elegant	気品のある	anc
connectivity	接続性	anc
microphone	マイク|マイクロフォン	anc
correlation	関連|相関|相互関係	anc
soldier	軍人|軍人になる|兵士|兵役につく	anc
illustrate	を明らかにする|説明する|例証する|挿絵を入れる|図解する	anc
depart	規則から逸脱する|立ち去る|出発する|軌道からそれる|この世を去る	anc
allergy	アレルギー	anc
similarly	同様に|類似して|同じく	anc
backpack	バックパック(を背負って自然に親しむ)(枠付きリュック)	anc
deer	シカ|鹿	anc
solely	ひとりだけ|ただ一人で|たんに	anc
radical	過激な|急進的な|すぐれた|根本の|急進党員|過激論者	anc
cab	タクシー	anc
reminder	思い出させる人･物|記念物|注意|助言|催促状	anc
cargo	船荷	anc
collaborative	共同の|共同作業の|合作の	anc
prototype	プロトタイプ|原型|手本|試作|模範	anc
chuck	軽くたたく|捨てる|放棄する	anc
declare	を宣言する|を明言する|を申告する	anc
cancellation	取り消し	anc
mandate	の統治を委任する|命令|為政権|指図|委任統治	anc
demographic	人口統計学の	anc
cylinder	シリンダー|円筒	anc
rover	立ち見の人|漂流者|流浪者|海賊|歩き回る人	anc
suggestion	提案|暗示	anc
yacht	ヨット|ヨットに乗る	anc
uncertainty	不確実さ|疑い|半信半疑|不確定|不安	anc
intensive	強い|強調の|集約的な|(文法)強意の|強意語	anc
thy	汝の|なんじの|そなたの	anc
spark	火花を出す|スパーク|火花(を散らす)	anc
collar	首飾り(colorとは発音異なる)|えり|首飾|首章	anc
worm	虫|寄生虫|虫けら|苦悩|徐々に進む|寄生虫を取り除く	anc
fragment	破片|断片|かけら|小部分|断章	anc
sensitivity	思いやり|神経のこまやかさ|感度|感性	anc
blanket	一面に覆う(もの)|毛布(で覆う)|全体的な|包括的な	anc
ye	なんじら|そなたたちは	anc
bowling	ボウリング|ボーリング	anc
significance	意義|重要性	anc
tri	3を意味する接頭語	anc
syndication	シンジケーション	anc
cedar	ヒマラヤスギ|(cedarは日本のスギとは違い|ヒマラヤ杉などマツ科のもの	anc
anxiety	心配	anc
um	えーと|うーん|ほー|ふむ|いや|へー	anc
drawing	引く|製図|素描|鉛筆で描く絵	anc
atomic	原子の	original
approx	約	anc
duplicate	複写する|写し	anc
supervision	管理|監督|指揮|監視	anc
ted	広げて干す	anc
foam	泡|あぶく|泡を出す|あわ消化剤	anc
performer	行為者|役者|行う人|演奏者|俳優|曲芸師	anc
noon	正午	anc
tuition	授業料	anc
sweep	さっと通過する|を一掃する|掃除する|(～を)掃く|を掃いて集める|圧勝する|大勝する	anc
dividend	公債利息|(株の)配当金|配当(金)|分け前	anc
sandy	砂(色)の|砂色の|砂のような|砂だらけの	anc
imperial	荘厳なる|皇帝の|帝国の|皇室の|壮麗な|皇帝(皇后)(の)	anc
disagree	意見を異にする|と一致しない|相違する|口論する	anc
mandatory	強制的な|命令の|統治を委任された|委任の	anc
rope	投げなわ|ロープ|なわ|一連	anc
disable	身体的障害のある|injured	anc
crucial	決定的な|きわめて重要な|ゆゆしい|致命的な|十字形の	anc
adjacent	隣接した|付近の|近接した|直前の	anc
indication	指示|暗示|兆候	anc
lemon	レモン|(俗)欠陥品|不良品|きずもの	anc
merit	長所|手柄|に値する	anc
offensive	不快な|いやな|攻撃|攻勢|無礼な|攻撃的な	anc
notion	心に思うこと|概念|観念|意向|意志|考え	anc
salmon	サケ|鮭|鮭肉(の)|鮭肉色(の)	anc
mess	乱雑|会食|混乱|失敗|散らかす|台なしにする	anc
surgical	外科手術の|外科医の	anc
calm	落ち着いた|静める|冷静な|平穏な|静かな|無風の|穏やかな	anc
boob	(俗)へま|まぬけ|(boobs|ぱいぱい|=boobies)	anc
glen	谷間|(G-)グレン(人名)	anc
ejaculation	絶叫|急に叫ぶこと|射出|射精	anc
yo	やあ	anc
swim	泳ぐ	anc
lotus	ロータス|蓮|ハス(の実)|ロートス(伝説の木)	original
biotechnology	生命工学|生物工学|バイオテクノロジー|人間工学|ergonomics	anc
soviet	〈C〉(旧ソ連の)地方会議(労働者・農民によって選出され|立法権・行政権を有する)|《the Soviets》『旧ソ連政府』;『旧ソ連人民』|地方会議の|《S-》ソ連の	ejdict
brunette	(女)ブルネットの	anc
daddy	お父さん	anc
bless	を神聖にする|感謝する|祝福する|恩恵を与える|清める|恵む|賛美する|十字を切る|祈る	anc
luggage	(UK英)(集合的)手荷物|旅行かばん	anc
pledge	誓約|質入|乾杯|を誓う|人質|保証する	original
bolt	稲妻|かんぬきで締まる|ふるいわける|ボルトで締める|かんぬきをかける|(B-)人名	anc
actress	女優	anc
toxic	有毒な|中毒の	anc
dl	deciliter[s]	ejdict
weapon	対抗手段|武器|兵器	anc
boom	にわか景気|オイルフェンス|とどろく音|ドカーン|ブンブン	anc
squad	班|隊|団|分隊|チーム	anc
honour	honorの英国綴り	anc
exempt	免れさせる|免れた|免除する|免疫の|免属の|免税者	anc
stimulate	を刺激する|を元気づける	anc
stylish	流行の|上品な	anc
divine	神聖な|神の	anc
autumn	秋(=fall)	anc
reel	リール|糸巻き|動揺する|よろめく|ふらつき歩く	anc
miniature	模型|小模型|ミニチュア|細密画|小型の	anc
victor	勝利者|征服者	anc
offshore	沖合い|沖で|(風など)沖に向かう|海外の	anc
retailer	小売業者	anc
spec	思惑|投機|演芸|仕様明細書	anc
alt	アルト(の)|中高音(の)	anc
occasionally	たまに|時折	anc
jail	刑務所|投獄する	original
emission	排出|放出|排気|放射|発射	anc
fountain	泉	anc
realty	不動産	anc
apparent	明らかな(叙述用法:apparent to, apparent thatなど)|外見上の(限定用法:be apparent)	original
instructional	教育の	anc
outreach	奉仕活動	anc
graduation	卒業	anc
poison	毒|毒薬|毒物|弊害|に毒を盛る|を毒する	anc
gig	ジャズ演奏の仕事|競漕用ボート	anc
integral	完全な|欠くことのできない|総体	anc
parade	行列|見せびらかし|を行進する|を見せびらかす	anc
exterior	外側の|外の|外観|外部の	anc
roller	(地ならし･印刷･圧延用)ローラー|大波|ヘアカーラー|ローラーカナリア	anc
shed	(血や涙を)流す|を脱ぐ|(動・植物が)葉・角・皮・毛・羽などを(自然に)落とす|生えかえる|脱皮する|(体重)を落とす|倉庫|小屋|車庫	anc
canal	運河	anc
excuse	言い訳	anc
people	人々|国民	anc
fraction	破片|一部分|端数|比|割合|分数	original
sandwich	サンドイッチ	anc
fancy	空想する|空想(力)|錯覚|気まぐれ|思いつき|好み|嗜好(しこう)	anc
chrome	=chromium|クロムまたはクロム合金をめっきした材料|クロム染料など	ejdict
timely	適時の|時期を得た|折りの良い|折りよく	anc
bingo	当たり|ビンゴ	anc
refresh	元気づける|さわやかな気分にする|を生き生きさせる|を新たにする|補給する	anc
relocation	(米語)(第二次大戦中の日系人)強制収容|再配置|移転	anc
leak	を漏らす|情報漏れ|漏電	anc
baseline	ベースライン(基線)	anc
sunny	晴れわたった|陽気な|日当たりのいい	anc
cox	舵手|舵取り	anc
explicit	率直な|明白な|あからさまな|(反義語)implicit	original
cuisine	料理|料理法|料理場|厨房	anc
radius	飛行半径|半径|輻射線|区域|範囲	anc
sept	7の意味(Septemberは9月に転じた)	anc
jar	かめ|びん|きしむ|がたがた揺れる	anc
cube	3乗する|立方体	anc
exemption	免税|課税控除	anc
translator	翻訳者|通訳|翻訳機|翻訳家	anc
exceptional	例外の|異常な|例外的な|異例の|特別に優れた	anc
whilst	一方(=while)	original
spatial	空間的な|空間の	anc
unto	の方へ(=toの古い用法)|〜まで|〜に	original
coral	珊瑚の	anc
snapshot	スナップ写真	anc
precious	気取った|貴重な|高価な|尊い|大事な|こりすぎた	anc
annually	毎年|年一回づつ|年刊	anc
chapel	礼拝堂	anc
lawsuit	訴訟|告訴	anc
synthesis	総合|統合|合成|組み立て	anc
heater	ヒーター|暖房	anc
forest	森林	anc
mug	(人を暗闇で)襲って金品を奪う|(俗)がり勉する|大型コップ|マグ|ジョッキ|(俗)つら|顔写真を作る|不良|まぬけ	original
replica	模造品|複製	anc
unavailable	得られない|利用できない|不在の	anc
footwear	履き物	anc
withdrawal	取り消し|引っ込めること|回収|脱退|撤退|預金の引き出し|払い戻し	anc
theorem	法則|定理(=axiom)|原則	original
advocacy	主張|弁護|支持	anc
prairie	(特にミシシッピー川流域の)『大草原』	ejdict
essentially	本質的に|元来|本来の|実質的に	anc
retreat	引退|避難所|退却|退却の合図|撤退する|避難(所)	anc
compromise	妥協(する)|譲歩(する)|和解(する)|(名誉･体面)を損なう|危うくする|歩み寄り|示談	anc
adaptor	アダプター|アダプタ|接着体|補助具	anc
interim	暫定の|中間の|暫定措置|合間	anc
taxi	タクシー|タクシーで行く|陸上をゆっくり進む	anc
barrel	容器|樽(1barrel=約117.3リットル)|銃身|胴体	original
laundry	洗濯	anc
vic	獲物	anc
bare	ありのままの|裸の|家具のない|最低限の|暴露する|公表する|reveal|disclose	anc
preservation	維持|保存	anc
berry	ストロベリー|ブルーベリー|ラズベリー|ブラックベリー|クランベリーなど多肉質の小果実の総称	anc
synopsis	概要|大意	anc
surname	姓|姓名|あだ名をつける|あだ名	anc
reprint	を翻刻する|再版|を再版する|を重版する|増刷	anc
nickname	にあだ名をつける|あだ名|ニックネーム|愛称	anc
millennium	千年|千年間|千年紀|千年祭|黄金時代	anc
melt	溶ける|和らぐ|融ける|次第になくなる|次第にやわらぐ|融かす	anc
appraisal	(価格･価値の)評価|価値判断|査定額|鑑定	anc
prep	準備	anc
technological	技術の	anc
flyer	ビラ|チラシ|小冊子	anc
remix	リミックス|複数の既存曲を編集して新たな楽曲を生み出す手法の一つ	anc
ecology	生態学|エコロジー|人間生態学|社会生態学|生態環境	anc
treasury	財務|国庫|基金|宝庫|宝物|公庫|資金	anc
inspiration	うまい思い付き|霊感|吸気	anc
wellness	ウエルネス|健康なライフスタイルを追求すること|フィットネスと共に80年代後半から米国で使用される	anc
calcium	カルシウム(金属元素)	anc
onion	玉葱|タマネギ	anc
pathway	小道|通路	anc
angry	怒った	anc
stake	杭|支柱|賭け(る)|利害関係|賭け資金|出資比率	anc
oasis	オアシス|慰安の場所	anc
differential	差別的な|(石油)油種間価格差	anc
tension	緊張|伸張|緊迫|電圧|張力	anc
locally	局所的に|場所的に	anc
registrar	記録(登録)事務官|登記官|(大学の)学籍係|(病院の)研修医|株式登録機関	anc
annex	別館|付録|付加物|付加する|併合する	anc
desperate	死にもの狂いの|絶望的な	anc
governmental	政府の	anc
mega	メガ|百万倍	anc
municipality	(地方)自治体	anc
sailing	帆走|航海|航行|(特に定期客船の)出帆	anc
tribute	賛辞|弔辞|贈り物|記念品|貢ぎ物	anc
dip	下落|落下|一汲み|をちょっと浸す|を汲み上げる|下降する|decline|decrease	anc
sacred	神聖な	anc
internship	インターンシップ	anc
lambda	(第11ギリシア文字)ラムダ|Λ|λ	anc
badge	バッジ|記章|袖章	original
decoration	装飾	anc
booth	屋台店|模擬店|小さく仕切った部屋|電話ボックス|ボックス席	original
heather	ヒース属の植物	anc
retention	保持(率)|保有|滞留|うっ滞(性)	anc
workstation	ワークステーション	anc
undefined	あいまいな|未定義の	anc
unemployment	失業	anc
cyber	サイバー	anc
petroleum	石油	anc
shuttle	(近距離間の)定期往復便|定期往復バス(列車･飛行機)	anc
silicon	シリコン|珪素(非金属元素)	anc
homework	宿題|家庭でする仕事	anc
identical	全く同じ|同一の	anc
lace	をひもで縛る|レースで飾る|レース|組み紐|ひも	anc
strict	几帳面な|厳しい|厳密な	anc
lover	恋人同士|恋人|愛好者	anc
eclipse	食|失墜|覆いかくす	anc
mu	(第12ギリシア文字)ミュー|Μ|μ	anc
shark	サメ|フカ|高利貸し|強欲な人|名人	anc
ripe	成熟した|熟した|熟れた|赤い|食べ頃の|化膿した	anc
bead	数珠玉|ビーズ|玉|ロザリオ|しずく|玉になる|玉で飾る|数珠つなぎにする	anc
rhythm	リズム|律動|律|韻律|調子|調和	anc
adolescent	青春期の	anc
rent	(家･車など)を賃借りする|を賃貸しする|使用料|賃貸料	anc
provincial	田舎風な|地方の|国の|県の|いなかの|地方人|偏狭な人	anc
separately	離れて|別々に	anc
physiology	生理学|生理|生理機能|生理現象	anc
triangle	三角定規|三角形|三人組み	anc
towel	タオル|手拭い	anc
participant	参加者|関係者|関与する	anc
cardinal	枢機卿|深紅色の|基本的な|主要な	original
recreational	レクリエーションの|娯楽の|気晴らしの|休養の	anc
sacrifice	いけにえにする|犠牲になる|供え物|いけにえ･犠牲|を犠牲にする	anc
sunshine	日向|日光	anc
josh	からかい|悪意のない冗談|冗談|冗談を言う|からかう|冷やかす	anc
batch	一揃い|(電算)バッチ(一度に処理するデータの束)|一群|(手紙の)一束|(パンなどの)一焼き(分)|一回分(のもの)|一団	anc
accountability	説明義務|会計責任	anc
penny	ペニー(銅貨)(英国などの通貨単位1|100 pound)|小銭|わずかな量|金額|(米･カナダの)cent|(一般的)金銭	anc
somehow	どうにか|なんとかして|どうくわけか	anc
diploma	卒業証書|公文書	anc
encryption	暗号化	anc
gal	ガル|加速度の単位	anc
affiliation	加入|合併|提携|(政治的な)友交関係	anc
embassy	大使館|使節団	anc
merger	合併|併合|混同	anc
stylus	棒状の筆記具|針|筆	anc
advertiser	広告者|広告掲載者	anc
slight	わずかな|軽微な|細い|かよわい|軽視する|ばかにする|なおざりにする|軽視|無礼|侮辱|冷淡	anc
filling	注入	anc
downloadable	ダウンロード可能な	anc
stitch	を縫う|ステッチ|一針|綴じ|ひと針|縫い目|布地	anc
mortality	死すべき運命|人類|死ぬ運命|大量の死|死亡数|死亡率	anc
trick	こつ|策略|いたずら|迷い|トリックの|を計略でだます|(俗)女の子|娼婦の客	anc
dash	粉々に打ち砕く|突進する|投げつける|激しく打つ|突撃|活気|a 100-meter dash(100メートル競走)	anc
intake	摂取量|水などの取入れ口|取り入れ	anc
toddler	よちよち歩きの幼児|歩き始めの子|1～2才児	anc
owe	負う|おかげだ|借りている	anc
equality	等しいこと|平等|同等	anc
tier	層|列|階段	anc
complement	補足|全数量|補足物|(文法)補語|補文|補数	anc
needle	針|注射針|を針で縫う|をいらだたせる|針葉樹の葉	anc
terrace	段地	anc
darkness	暗がり|暗さ|無知|失明|秘密	anc
dairy	酪農場|バター･チーズ製造室(所)|乳製品販売店	anc
wallet	小道具袋|札入れ|ずだ袋|財布	anc
stocking	ストッキング|蓄える|靴下	anc
respondent	応ずる|返答する|回答者|被告|答弁者	anc
debut	初舞台|初演|駆出し|デビュー	anc
nerve	を元気づける|神経|度胸|ずぶとさ	anc
forge	鍛造する|焼きなましする|を形作る|溶鉄炉|鍛冶工場	anc
embrace	抱きしめる|包含する|捕える|囲む|抱擁|包囲|容認|(遠回しに)性交	anc
appliance	器具|器械	anc
univ	大学	anc
impose	課す|押しつける	anc
timber	材木|木材|森林|樹木|材料	anc
enlargement	拡大|拡張|増補|引伸し|詳述	anc
anger	怒り|怒らせる|怒る	anc
impressive	強い印象を与える|印象的な|感動的な	anc
sheep	羊|ヒツジ|温良な人|羊皮	anc
accordingly	それゆえ|というわけで	anc
courier	急使|(旅行の)ガイド	anc
maximize	極大化する|最大にする	anc
guild	同業組合|商人団体|ギルド|組合	anc
fever	熱|発熱	anc
discretion	行動の自由|思慮深さ|慎重さ|判断力|決定権	anc
tackle	取組む|タックル(する)|道具|ろくろ	anc
newbie	初心者	anc
interpret	を解釈する|を通訳する	anc
poem	詩	anc
jeep	ジープ	anc
cage	骨組み|鳥篭|監獄|ゴール|かご(にいれる)|(ボール･パックを)ゴールにいれる	anc
allowance	協定損害率|～料|割当額|手当|支給金	anc
unsigned	署名されていない	anc
tariff	関税|関税率|関税表|関税法|運賃|料金表	anc
veteran	(米語)老練者|老練家|ベテラン|古参兵|退役軍人|老練の	anc
gather	集める|知る|推測する	anc
gentleman	男のかた|紳士|例の男|諸君	anc
sage	聖人|思慮深い|賢い|賢人ぶった	anc
realistic	現実主義の	anc
bind	結ぶ|を束縛する|縛る|包む|を固める	anc
absent	ぼんやりした|不在で|を欠席する	anc
cant	(職業などの)合い言葉|特殊用語|(もったいぶった)偽善的なことば|傾斜|傾く	anc
shout	叫ぶ|大声で言う	anc
conjunction	結合|連結|合同|(文法)接続詞	anc
chill	冷たい|寒気|寒さ|冷感|冷える	anc
nuke	(見出語)nuclear|核兵器(で攻撃する)|電子レンジで調理する|暖める	anc
congressional	議会の	anc
tribune	(古代ローマの)護民官|人民の権利の擁護者	original
hardly	ほとんど～ない|骨折って|とても～ない|苦労して	anc
advert	広告する|広告	anc
buzz	がやがや言う|ざわめき|音|ブンブン|ハチの音|ブザーで呼ぶ	anc
contrary	反対の|逆の|反対の･逆の|反して	anc
photographic	写真(用)の(ような)|鮮明な	anc
earthquake	地震	anc
invalid	効力のない|病弱者|病人|病弱な|傷病兵|無効な	anc
pixel	ピクセル|画素	anc
jewel	宝石	anc
validation	検証	anc
polo	ポロ(乗馬で球を打つスポーツ)|POLO(服飾メーカー名)|Polo(車名)	original
pest	厄介な人･物|害毒|有害な小動物･虫|悪疫|ペスト	anc
witch	魔女|醜い女|に魔法をかける	anc
wheat	小麦	anc
rage	激怒|逆上|大荒れ|猛威|激情|熱狂(する)	anc
corruption	腐敗|不正行為|汚職|賄賂|買収	anc
additionally	さらに	anc
kidney	腎臓|性格|気質|種類|型|キドニービーンズ(豆の名)	anc
nonprofit	非営利的な	anc
circular	円形の|円の|丸い|巡回の|ちらし|回状|循環する	anc
therapist	療法士	anc
wax	ろう|ろう状物質|ワックス|レコード|耳あか|激怒|大きくなる|かんしゃく|満ちる	anc
undergo	経験する|(試験･手術などを)受ける|(災難などを)被る	anc
martial	好戦的な|軍の|戦争の|軍人らしい	original
ballot	投票用紙|(無記名)投票(する)	anc
unity	統一	anc
payroll	給料支払表|従業員数|給料支払い名簿	anc
climb	登る|昇る|上る	anc
deviation	本筋からはずれること|方針からの逸脱|偏り|偏差|脱線	anc
chaos	混乱状態	anc
reading	読書力|読書|知識|学識|朗読|読み物	anc
roster	勤務表|名薄|名簿	anc
decorative	飾りになる|装飾の|装飾的な	anc
genome	ゲノム|生殖細胞に含まれる染色体または遺伝子全体|ある生物の持つ全ての核酸上の遺伝情報	anc
bounce	はねる|弾む|活気	anc
lap	座った時の腰からひざ頭まで|子供等のせる場所|(猫, 犬などが)なめること|さざ波の音|(競技)走路の一周	original
neighbor	近所の人|隣人	anc
nudist	ヌーディスト|裸体主義(者)|ヌーディストの|裸体主義の	anc
uncle	おじ	anc
cheque	小切手(英)|=check(米)	anc
authorize	に権限を与える|委任する|(正式に)認可する|公認する	anc
auditor	監査役	anc
mono	単一の|単独の	original
hose	ホース|長靴下	anc
belly	腹|食欲|胃|腹部|ふくらます	anc
aye	賛成|しかり|はい	anc
indigenous	土着の|生来の|原産の|自生の|土地固有の|原住民の|土着	anc
grammar	文法学|文法	anc
clarify	明らかにする|ハッキリさせる	anc
questionnaire	アンケート|質問|質問書	anc
startup	スタートアップ|開始	anc
cholesterol	コレステロール	anc
tide	潮|潮流|潮の干満|潮に乗って|潮汐	anc
cope	うまく対処する|対抗する|うまく処理する	anc
thee	(thou の目的格)なんじに(を)	anc
folder	書類はさみ|折りたたみ器|紙挟み|折りたたみパンフレット	anc
dramatic	劇的な|劇の|ドラマティック	anc
terrible	恐ろしい|ひどい	anc
innocent	無垢な|あどけない|無罪の	anc
curious	好奇心の強い	anc
butler	執事|バトラー	anc
scientist	科学者	anc
bloom	開花させる|栄える|花が咲く|若さ|美人|花盛り|開花|花	anc
arthritis	関節炎	anc
nevertheless	それにもかかわらず|それでも|やはり	anc
fist	こぶし|拳固	anc
taxation	課税|徴税|租税|税収	anc
inflation	インフレーション|インフレ|暴騰|膨張	anc
whale	クジラ|鯨	anc
subdivision	再分割|解体	anc
locale	場所|舞台	anc
surely	確実に|確かに	anc
flush	ほおがぱっと赤らむ|(空が)ばら色になる|メモリをクリアする	original
bridal	花嫁の	anc
freight	貨物運送|空路運送|船荷|普通便|運賃|船賃	anc
topless	上部のない|非常に高い	anc
reasonably	合理的に	anc
harmony	ハーモニー|調和|一致|平和|和声	anc
cattle	ウシ|牛	anc
stir	混乱|かき回すこと|かき混ぜる|を動かすをかき回す|を奮起させる|動く	anc
controlling	制御	anc
monetary	貨幣の|金銭上の|金融の	anc
elderly	中年を過ぎた|初老の|年配の|時代遅れの|年配|老齢	anc
pathology	病理学|病理|病状|前足で掻く|蹄で掻く	anc
premiere	初日|主要な|主演の	anc
swallow	を飲み込む|納得して受け入れる|ツバメ	anc
extraordinary	異常な|突飛な|臨時の|奇妙な|驚くべき|特別な	anc
exclusively	もっぱら|排他的に|一途に|専ら	anc
tolerance	寛容|寛大|容認	anc
parcel	小包|一組|包み|土地の一区画|を分配する|を小包にする	anc
limitation	限度|限界	anc
scatter	散乱させる|をまき散らす|散らす	anc
sprint	短距離走	anc
deficit	欠損|不足|赤字	anc
warning	警告|警報	anc
nu	(第13ギリシア文字)ニュー|Ν|ν	anc
marina	マリーナ(ヨットやモーターボートなど娯楽用小型船舶を係留する港)	anc
mainstream	主流(の)	anc
tribal	部族の	anc
sponsorship	後援|資金提供|助成金|保証人であること	anc
sofa	ソファー	anc
motivation	動機づけ|刺激|やる気	anc
geometry	幾何学	anc
norm	基準労働量|標準	anc
fairy	妖精|(俗)ホモ	anc
actively	活発に	anc
wound	傷つける|心の傷|wind(巻く, 吹く)の過去･過去分詞	original
ciao	(伊)チャオ|さようなら|おはよう|こんにちは	anc
chem	(略語)chemistry, chemical, chemist	original
taxpayer	納税者	anc
unlikely	ありそうもない|しそうもない|見込みのない	anc
steady	安定する|規則的な|安定した|変わらない|一様の	anc
penguin	ペンギン	anc
coefficient	係数|率	anc
oppose	反対する	anc
brave	勇ましい|勇敢な|派手な|勇士	anc
circulation	発行部数|循環	anc
techno	テクノ	anc
humidity	湿度|湿気	anc
immune	免疫の	anc
traveler	旅行者|旅客|外交員|移動販売員	original
recruit	新社員|補充兵|新参者|を募集する|を強化する|補充する|人員を募る	anc
forestry	林学|林業	anc
rarely	めったに～しない|まれに|例外的に	anc
clan	一族|一味|仲間	anc
offering	提供する|上演|贈り物|販売	anc
barrier	防壁|柵|仕切り|境界|国境のとりで|検問所	anc
incorrect	正しくない|間違った|無作法な	anc
narrative	物語の|物語|談話	anc
furnishings	家具|備品	anc
reside	が備わっている|住む|居住する|駐在する|存在する	anc
caution	注意	anc
thereby	それによって|その結果	anc
fade	衰えさせる|さめる	anc
particle	微少量|粒子|微粒子|微量|不変化詞(前置詞･接続詞･接頭(接尾)辞など)	anc
lip	に唇をあてる|を穴のふちにあてる|唇を使う|をつぶやく|唇の|口先だけの|生意気な言葉|唇	original
strive	努力する|戦う	anc
harbour	港|(US英)harbor	original
renaissance	ルネッサンス|文芸復興	anc
donna	イタリアの貴婦人	anc
breach	絶交|(法律などの)違反|裂け目|破棄|侵害|中断|突破口|(俗)不履行	anc
enclosure	包囲|同封物	anc
expo	博覧会	anc
restrict	を制限する|限定する	anc
dye	染まる	anc
reef	鉱脈|暗礁(=sunken rock)|岩礁|砂州	anc
phi	(第21ギリシア文字)ファイ|Φ|φ	anc
chess	チェス	anc
curtain	幕で覆う|カーテン	anc
token	しるし|印|徴候|証拠|記念品|土産|表象|記念の品|(形容詞的に)形だけの	anc
marble	おはじき|大理石|大理石の彫刻|知恵	anc
dolphin	イルカ	anc
ant	アリ|蟻	anc
amino	アミノ基の	original
alignment	照準|配列|アラインメント|一直線|配置|整列	anc
analytical	分解の|分析的な|解剖的な	anc
validate	有効にする	anc
transmit	伝える|convey|を送る|を伝達する|送信する|発信する	anc
interrupt	話しを邪魔する|の邪魔をする|を妨害する|を中断する|口を挟む	anc
insist	(強く)主張する|言い張る	anc
approximate	おおよその|接近する|隣接の|近似の|近付く|近似値	anc
hypothesis	前提|仮説|仮定|憶測	anc
miracle	奇跡|奇跡的な出来事	anc
hobby	道楽|趣味|ホビー	anc
patio	(米語)パティオ(テラス,中庭)	original
consortium	協会|組合|コンソーシアム	anc
colony	植民地|移民	anc
cognitive	認識の	anc
helicopter	ヘリコプター	anc
distinction	区別	anc
enquiry	引き合い	anc
subcommittee	分科委員会	anc
regulator	調速器|レギュレータ	anc
intense	激しい	anc
librarian	図書館員|ライブラリアン|司書	anc
playlist	プレイリスト	anc
valuation	評価|値踏み|評価額|見積価格	anc
elephant	ゾウ|象|米共和党(Republican Party)の象徴	anc
supporter	サポーター|支持者|扶養者|支柱	anc
cliff	がけ|崖	anc
dirt	ごみ|ほこり|うわさ話|スキャンダル|無価値なもの→うわさ話	anc
assert	断言する|主張する	anc
sail	帆|帆船|帆走|帆走する|(～を)航海する|出帆する	anc
publicly	公に|公然と	anc
hourly	1時間ごとの|たびたびの	anc
patriot	愛国者	anc
linen	亜麻布|亜麻糸	anc
ala	悲しいかな|(鳥･コウモリ･昆虫の)翼	original
veterinary	獣医の|獣医	anc
pencil	えんぴつ	anc
dancer	踊る人	anc
adviser	助言者|忠告者|顧問	anc
informal	正式でない|非公式の|略式の|変則の	anc
relevance	(当面の問題との)関連(性)|適切さ|妥当性	anc
incentive	刺激的な|鼓舞する|激励|動機|奨励金|刺激|動機づけ	anc
ping	おしっこをする|ピーンと音を出す|ピューと飛ぶ	anc
heavily	重く|重そうに|激しく|濃密に|ひどく|重々しく|密に|のっそり|猛烈|物物しい	anc
gallon	ガロン(約3.8リットル)	original
crush	押しつぶすこと|粉砕	anc
porcelain	磁器製の|磁器|磁器製品	anc
swinger	活発で現代的な人|時流の先端をいく人|性的に自由奔放な人	anc
rid	を自由にする|免れさせる|を取り除く|を駆逐する	anc
header	(くぎなどの)作頭機|穂摘み機|(俗)さかさ飛込み|ヘッディングによるシュート(パス)	anc
numerical	数の|実数の	anc
spirituality	霊性	anc
ecosystem	生態系	anc
servant	使用人|従業員|召し使い|召使|奉仕者	anc
latitude	緯度|許容範囲|自由裁量	anc
sap	〈U〉樹液|〈U〉活力|生気|元気|〈C〉《話》ばか|まぬけ	ejdict
dessert	デザート	anc
frontier	フロンティア|国境|辺境地帯|未研究分野|境界	anc
sodium	ナトリウム(英sodium|独Natrium)	original
fate	巡り合わせ|宿命|予言|悲運|破滅|死|最終結果|運命づける	anc
missile	ミサイル|飛び道具	anc
meanwhile	ところで|その間に|一方では	anc
proprietary	所有主の|所有の|所有者の|独占の	anc
timothy	(植物)オオアワガエリ|売春宿	anc
inquire	尋ねる(=enquire)|質問する	anc
naval	海軍の	anc
mixer	ミキサー|音量調整係|社交家	anc
medieval	中世の|古めかしい	anc
shaft	シャフト|矢がら|ハンマーなどの取っ手|光の一筋	anc
decent	礼儀正しい|上品な|親切な|(口)結構な|まあまあの|悪くない	anc
essence	本質	anc
shortly	間もなく|まもなく|手短に|簡単に|ぶっきらぼうに	anc
inspire	に霊感を与える|気持ちを強く動かす|奮起させる	anc
schema	概要|大意|図解|格|比喩	anc
consensus	意見一致|一致|総意|全員一致	anc
journalism	ジャーナリズム	anc
valium	バリウム	original
cordless	コードレス	anc
rotation	規則正しい交替|回転	original
prefix	電話局番|人名の前に付ける敬称|の前に付ける|接頭辞|接頭語	anc
conviction	信念|有罪判決	anc
pile	積み重ね|大量の|大金|積み上げる|杭 2|piles 痔	anc
rant	大げさに言う|大声を張り上げる|わめき散らす	anc
deed	行為|行い	anc
retro	レトロ|リバイバル|復古調スタイル|レトロの|復古調の|リバイバルの	anc
statewide	州全体の	anc
memo	覚え書き|メモ|摘要	anc
telescope	望遠鏡	anc
conform	従って行動する|一致する|従わせる|従う	anc
mainland	大陸|本土	anc
handy	耐久力のある|上手な|器用な|便利な	anc
happiness	幸福|幸せ|適切さ	anc
substantially	しっかりと|実質的に|十分に	anc
jaguar	ジャガー(中南米産)	anc
invasion	侵入	anc
punishment	罰|罰すること|罰を受けること|処罰|刑罰|虐待	anc
bizarre	変な|奇妙な|odd|風変りな|異様な	anc
identifier	識別子	anc
thriller	ぞっとさせる物|スリラー物|スリルを与えるもの|スリラーもの	anc
colonial	植民地の	anc
lamb	子羊|柔和な人	anc
patrol	パトロール(隊)|(～を)巡回する|巡回者	anc
tuner	調律師	anc
gorgeous	華麗な|豪華な|見事な	anc
realm	範囲|領域|部門|王国|国土	anc
oriental	東洋の|東の|(宝石･真珠が)上質の|光沢の美しい	anc
freelance	自由契約の|フリーランサー|自由契約者	anc
confusion	混乱|混同|当惑	anc
nervous	いらいらする|神経質な|臆病な|神経の	anc
vault	金庫|貴重品保管室|丸天井|地下室|貯蔵所	original
col	コル|鞍部|気圧の谷|鞍形等圧線	anc
transcription	写すこと|複写|転写|コピー	anc
regulate	を規定する|を制限する|を調整する|を調節する	anc
addict	熱中させる|麻薬中毒者	anc
superb	すばらしい|荘厳な|豪華な|とびきりの	anc
transparent	透明な|明白な|透き通る|透けてみえる|薄い|率直な|わかりやすい	anc
purse	すぼめる|富|財布|がま口|ハンドバック|金|資金	anc
doom	(通例悪い)運命|悲運|凶運|運命づける	anc
trinity	三位一体(神･キリスト･聖霊を一体と見る)	anc
promo	宣伝広告|番組予告|販売促進)(の手段)	anc
turtle	海亀|カメ|キジバ ト	anc
cease	しなくなる|をやめる|終わる	anc
continent	自制心のある|大陸	anc
freak	奇形|変種|気まぐれ|～気違い(～が大好きな人)|奇人|変人	anc
forbid	を禁ずる	anc
counselor	カウンセラー|相談役|弁護士	anc
inappropriate	不適当な	anc
levy	課税(する)|(強制的に)課する(=impose)|差し押さえる(=seize)	original
hydrogen	水素	original
vocational	職業(上)の|職業教育の	anc
nasty	むかつくような|いかがわしい|汚い|ひどく不潔な|いやな|わいせつな	anc
girlfriend	ガールフレンド	anc
disco	ディスコ(音楽)|ディスコで踊る	anc
alloy	合金|合金に用いる安価な金属|まぜ物|品位|純度	anc
remark	と述べる|言う|意見|言葉	anc
transsexual	性転換者|両性具有の人･動物	anc
fin	(魚の)ひれ	anc
resist	に抵抗する|に耐える|を追い払う	anc
asthma	喘息	original
frost	つや消しにする|霜で履う|寒気|厳寒|凍結|冷淡|冷酷|霜	anc
developmental	開発の|開発的な|発生の|発達上の|発展的な	anc
thesaurus	類語辞典	anc
bound	縛られた|～する義務がある|はずむ|躍動する|境界|限度|範囲	anc
refrigerator	冷蔵庫	anc
surplus	黒字|剰余|余剰|余り|余った|過剰の|余剰の|黒字の	anc
parse	を構成要素に分析する|の語尾変化を記述する|文法的に解剖する	anc
algebra	代数学|代数 (図形以外のmath)	anc
breakdown	突然の故障|機能停止|挫折|崩壊|内訳|分類	anc
ugly	醜い|(道徳的に)悪い|(天候)荒模様の	anc
lower	より低い|低くする|下げる|低くなる|下がる	anc
trash	紙くず入れ(=wastebasket)	anc
neglect	を無視する|怠る|怠慢|無視	anc
checklist	照合簿	anc
armor	よろいかぶと|よろい|防護具	anc
symphony	シンフォニー|交響曲	anc
whip	を鞭で打つ(こと)|を激しく打つ|打負かす|励ます|急に動かす|あわだたせる|猟犬係|ホイップ	anc
violate	に違反する|(法律･規則)を破る|を妨害する|犯す|違反する|乱す|強姦する|邪魔する	anc
toolbox	ツールボックス	anc
durable	耐久力のある	anc
comparable	比較できる|同等の	anc
chick	ヒヨコ|(俗)女の子|(とくに)魅力的ではつらつとしている女の子	anc
meditation	めい想|瞑想|熟慮	anc
wool	羊毛|毛糸|毛織物	anc
yea	しかり|さよう|じつに|本当に|賛成投票|賛否	anc
thong	革の細ひも|ひも	anc
spike	大くぎ|(塀の)忍び返し|(競技用の靴の)スパイク|(植物)穂	anc
orgasm	オーガズム|激情	anc
overhead	オーバーヘッド|頭上の|頭上で|頭上にある	anc
vertex	最高点|頂上|山頂|頭頂	anc
eco	エコ|economyの略|架空の人物名|エコ(通貨)	original
glow	燃えるような色|輝く|ほてり|ここちよい満足|熱情|光を放つ	anc
earl	伯爵	anc
mistress	女主人|主婦|女教師|女性の大家|情婦	anc
vulnerable	弱い|もろい|傷つきやすい|無防備な|感情に流されやすい|誘惑に乗りやすい	anc
washer	ワッシャー|洗う人|洗濯女|洗濯機	anc
artistic	美術家の|芸術的な|風雅な	anc
playboy	プレイボーイ	anc
indie	インディー|音楽の一つのジャンル|独立プロダクション|自営の	anc
polar	北極の|イオン化した|正反対の|中枢の	anc
precise	堅苦しい|正確な|明確に|まさにその|ちょうどその|厳格な	anc
respiratory	呼吸の	anc
bump	どすんと当てる|衝突|ドスン|衝突の音	anc
seafood	シーフードの|海産食品|魚介	anc
volleyball	バレーボール	anc
prophet	予言者	anc
polymer	モノマー(単量体)が多数結合した重合体	original
elevation	上げること	anc
sketch	スケッチする|スケッチ|草案|概略	anc
prop	支持者|支え|を支える|を支持する|に支柱を施す	anc
demon	悪魔(=daemon)	anc
maternity	母性|母であること|妊産婦のための|出産用の	anc
lightning	稲光|稲妻|稲妻のような|すばやい	anc
indirect	間接の|遠回しの|曲がった|不正な|遠回りの	anc
roast	ロース肉|を焼く|あぶる|焼き肉|焼いた|あぶった	anc
mattress	マットレス	anc
lonely	連れのいない|孤独の|寂しい|心細い|孤立した	anc
amongst	の中に(=among)	anc
vampire	吸血鬼|人を食いものにする悪人	original
deeply	深く	anc
italic	(活字が)イタリック体の|《複数形で》イタリック体活字|斜字体	ejdict
doctrine	主義|教義|原理|原則|学説|基本外交政策	anc
transvestite	異性の服装をする人	anc
creativity	創造性|独創力	anc
intersection	交差|交差点	anc
proposition	提案|申し込み	anc
imagination	機知に富んでいること|想像力|構想力|創作力|空想	anc
gag	の口に詰める|言論統制|冗談|自由な言論の抑圧	anc
civilization	文明|文化|教化	anc
oops	うわっ! しまった!	anc
nipple	乳首	anc
deficiency	不足|欠乏|欠陥|lack|insufficiency	anc
stomach	食欲|胃|腹|好み|～したいという気持ち	anc
trio	トリオ|三重奏(曲, 団)|三人組み|三重唄(曲, 団)	original
statue	像|彫像|塑像	anc
fireplace	暖炉	anc
behavioral	行動の	anc
riverside	河辺の	anc
airplane	飛行機	anc
variant	種々の|異なった|相違する|一致しない|変種の|変化	anc
offence	攻撃|違反|罪|侮辱|立腹	anc
karaoke	カラオケ|カラオケの	anc
fur	毛皮(製品)|柔毛|毛皮製品	anc
hereby	これによって	anc
dude	男|やつ|野郎|(呼び方として使われる)	anc
refill	(飲食物の)おかわり|2杯目|再び(re)満たす(fill)→(飲食物の)おかわり|詰め替える|再び満たす	anc
simultaneously	同時に|いっせいに	anc
racial	人種上の|人種の|民族の|民族間の	anc
designation	指示|指名|意味|指定	anc
hart	雄じか	anc
treasurer	会計係|出納係|会計担当者|出納官	anc
sociology	社会学	anc
vagina	腟	anc
confident	確信している|大胆な	anc
visibility	見通し	anc
officially	公式に|職務上	anc
burst	突発する|破裂する|破壊する|充満する|感情の爆発|裂く|爆発する|急に起こる|押さえ切れない|破裂した	anc
battlefield	戦場	anc
mighty	大きい|非常に|力強い|強力な|巨大な|並外れた|膨大な|重大な|多量の	anc
cheerleader	チアリーダー	anc
alto	アルト(女性の低音部歌手)	original
ought	～すべきである	anc
delicious	おいしい	anc
borough	自治町村	anc
reconstruction	復元|再建|改造|復興	anc
safely	無事|安全に|無事に	anc
finite	限定された|限りある|有限の	anc
periodically	周期的に|定期的に	anc
scooter	スクーター	anc
testament	契約|新訳聖書|遺言|遺言書|遺書	anc
jungle	ジャングル	anc
moisture	水分|湿気	anc
rub	こする|障害|摩擦	anc
undo	元に戻す|取り消す|はずす|脱がせる	anc
rename	改名する	anc
synthetic	合成した(fiberなど)|総合的な	anc
explosion	爆発|破裂|急増	anc
occurrence	出来事|起こること	anc
vegetable	植物人間|野菜|植物|活気の無い人	anc
dispatch	急送(する)|発送(する)|片付ける|速達|電報|派遣	anc
thumb	親指	anc
independently	自主的に|自由に|他と関係なく|独自に	anc
consciousness	自覚|意識|思想|感情	anc
groove	楽しいもの|溝|わだち|レコードのみぞ	anc
distinguish	を見分ける|を区別する	anc
custody	拘留|保護|管理|拘置	anc
banana	バナナ	anc
trance	失神|有頂天|恍惚状態|夢中|昏睡状態	anc
serum	血清	anc
similarity	類似点|類似(点)	anc
dependency	依存(の状態)|属国|保護領	anc
hay	干し草|馬草(家畜の飼料)|を干し草にする|に干し草を与える|干し草を作る	anc
novelty	目先の変わった商品|珍しさ|目新しさ|新しい物(こと)	anc
mere	単なる|ほんの	anc
clue	手がかり|筋道|かぎ|手掛かり|糸口|端緒	anc
ham	豚のもも肉|ハム|ひざの裏側|(俗)大根役者|大げさに演ずる|アマチュア無線家	anc
goat	ヤギ|好色漢	anc
mutation	突然変異|変化	anc
activate	放射能を与える|活性化する|活動的にする|活動させる	anc
instrumental	役に立つ|計測(計器)による|(文法)助格(の)	anc
homeland	母国|自国	anc
sphere	分野|球|範囲	anc
multiply	掛ける|増加させる|増やす|増える|増す	anc
pastor	牧師	anc
educate	を教育する|(教養など)を養う|(動物など)を仕込む	anc
bouquet	花束|(ワインなどの)香り	anc
manuscript	原稿|写本|手書き	anc
favour	favorの英国綴り	anc
chronicle	年代記|記録|年次報告|歳史|書き止める	anc
crest	ネジ山の頂|とさか|頂点|絶頂	anc
flux	絶え間ない変化|不安定|流れ|流量|溶剤	anc
ladder	はしご|地位|(パンストの)伝線(run)	anc
sq	平方(square)の略	original
sync	同調	anc
arctic	北極(地方)|Arctic北極の	original
ambassador	大使|使節	anc
beneath	〜の下に	original
tract	広がり|広い地面|地方|地域|小論文|小冊子|パンフレット(特に宗教関係の)	anc
monument	記念碑|遺跡|記念物|不朽の業績|墓石	anc
terminate	を終わらせる|に終わる|を終結させる|を仕切る	anc
accomplish	を成し遂げる|完成する|成就する|実行する	anc
thunder	雷|雷鳴|落雷|雷が鳴る|を大声で言う	anc
infrared	赤外線|赤外線の	anc
appreciation	感謝|高い評価|正しい認識|鑑賞	anc
oval	楕円|卵形の|長円形の	anc
aggressive	積極的な|攻撃的な|迫力たっぷりの	anc
leverage	てこの作用|借入金で投資する|利用する|utilize	anc
swear	swore(過去形), sworn(過去分詞)|誓って言う|誓う|断言する	original
caption	に見出しをつける|(記事などの)表題|(ページなどの)見出し|字幕|説明文|キャプション	anc
vent	(気体･液体用の)穴|通気孔|抜け口|出口|はけ口を与える|水面に顔を出す	anc
bud	つぼみ|芽	anc
chorus	コーラス	anc
dominant	優勢な(反義語recessive)|主要な|有力な	original
headline	見出し	anc
poly	polyester|polymer|polyethylene等の略(多数の意)	anc
lightweight	ライト級|標準体重以下の人(物)|(競技)ライト級の選手|(口)つまらない人	anc
neo	ネオ	anc
settle	を置く|を落ち着かせる|を清算する|定住する|据える	anc
pharmacology	薬理学|薬物学|薬学	anc
boulevard	大通り|並木道(仏語Boulevard)	original
gravity	重大さ|厳粛さ|危険|重力|重量|比重 (Universal Gravity万有引力)	anc
leap	ぴょんと飛ぶ|跳ぶ|はねる|を跳び越える|飛躍|急激な変化	anc
consistently	首尾一貫して	anc
powerpoint	パワーポイント(プレゼン用ソフト)	anc
manor	(英)(封建制度下の)荘園|manor house邸宅|(英)警察の管区|なじみの場所|所有地	anc
administer	施行する|管理する|与える	anc
providence	神の導き|摂理|神意|倹約|神業|先見	anc
sonic	音響の	anc
mild	温和な|温暖な|穏やかな|柔らかな|やさしい|軽い	anc
initiate	始める|起こす|創始する	anc
subsequently	後で	anc
bailey	外壁|城の中庭	anc
gentle	おとなしい|優しい|穏やかな	anc
ensemble	(仏語)全体|全体の趣|アンサンブル|婦人服のひと揃い|集合|共演者団	anc
scam	詐欺|信用詐欺	anc
restriction	制限(条件)|限定	anc
wilderness	荒野|だだっ広いところ|ごたごたした集まり	anc
protector	保護装置|保護者|後援者|防御物	anc
insertion	広告掲載	anc
quad	4つの	original
humanity	人類|人間性|(複数形で)人の属性|博愛|人情|慈善行為|人文科学	anc
hull	(穀粒･種)外皮|殼|果皮|さや|へた|船体|艇体	anc
genius	(非凡な)才能|天才|特質	anc
curse	呪う|冒涜する|呪い(の言葉)|悪態|悪口(を言う)|破門する	anc
handicap	身体(精神)上の障害|ハンディキャップ|不利な条件	anc
granny	おばあちゃん(=nan, nana, nanny, granny, grandma, granma, gran)	original
whore	売春婦|Attention Whore(俗|見て見て|などの意)	anc
lid	ヘルメット|マリファナの小さな包み|蓋|ふた|目蓋	anc
hierarchy	ヒエラルキー|職階級|階層制度|職階制|階級組織	anc
tractor	トラクター|引く人|引くもの	anc
coil	ぐるぐる巻く|コイル	anc
rival	商売がたき|競争者|対抗者|ライバル|対抗する	anc
react	反応する|反発する	anc
vet	獣医|(動物を)診療する|精査する	anc
partially	部分的に|一部分|不十分に|不公平に|一部分は|っ部分的に	anc
cn	cn|中華人民共和国の国別コードトップレベルドメイン	anc
stripe	ストライプ|しま|筋	anc
shame	残念|恥かしさ|恥|不名誉|残念なこと|を恥じさせる	anc
owl	フクロウ|もったいぶった人	anc
revolutionary	革命の	anc
computation	計算(法)|評価	anc
fog	を濃霧で包む|当惑|霧|濃霧|煙霧|煙|ほこり|混乱|を曇らせる|を混乱させる	anc
aboriginal	土着の|もとからある|原住民	ejdict
boulder	ゴロタ石|大きな岩	anc
anatomy	解剖|解剖学|解剖論	anc
ivory	象牙製の|象牙|象牙色|象牙製のもの|(ピアノの)キー|(玉突の)玉	original
rifle	ライフル銃	anc
watershed	(社会的に大きな)転換点|重大な転換点|分水界|流域	anc
cocktail	カクテル	anc
clarity	明瞭|明快|清澄さ|透明さ	anc
exclusion	排他	anc
aerial	(UK英) 空気の|空中の|航空(機)の|アンテナ	anc
spill	こぼすこと|をこぼす|をばらまく|流す|溢れる|浪費する	anc
orbit	軌道|行路|眼窩|眼球孔|の周りを回る|軌道を周回する	anc
barn	納屋|物置|倉庫	anc
beneficial	ためになる|有益な	anc
stain	しみ|汚れ|汚点	original
boutique	ブティック	anc
necessity	不可欠な存在|必需品|必要|日用品|必要性|貧乏	anc
robust	丈夫な|健全な|頑丈な|体力のいる|粗野な|強い	anc
booking	予約|簿記	anc
catalyst	触媒|触媒のはたらきをする人	anc
ver	バージョン	anc
cult	礼讃|信仰|宗派	anc
zen	禅	anc
thrill	をぞくぞくさせる|ぞくぞくする|を感動させる|震え|振動|スリル	anc
alpine	高山の|Alpine combinedアルペン複合(スキー競技名)	anc
minus	差引いて|を引いた|マイナスの|以下の|マイナス|不足	anc
fabulous	架空の|信じられないような	anc
reservoir	貯蔵所|宝庫	anc
individually	個々別々に	anc
literally	文字どおりに|文字通りに|逐語的に|まったく|本当に|事実上	anc
ecological	生態学の|生態学上の	anc
panic	パニック|恐慌|をうろたえさせる|うろたえる	anc
thickness	厚さ|厚いこと|密集|密生|繁茂|頻繁	anc
accreditation	認証評価	anc
maritime	海運上の|海の|近海の|臨海の|船員の	anc
periodic	定期的な|周期的な|断続的な	anc
sip	すする|(飲み物の)一口|(～を)少しずつ飲む	anc
aurora	極光|オーロラ|夜明け	anc
convince	を納得させる|確信させる	anc
ware	瀬戸物|商品|陶器	anc
duo	二重奏(曲|団)|二重唄(曲|団)	anc
tar	タール|を汚す	anc
magnitude	重要さ|重要性|大きさ|大きいこと|(天体)光度|等級|マグニチュード	anc
geographical	地質学上の	anc
flesh	激励する|肥やす|肉|身|贅肉|食用肉|肉体|人類|生物|肌	anc
holly	セイヨウヒイラギ	original
scripture	(常に複数形で)聖書(の一節)	anc
regression	後戻り|復帰|後退|退歩|退化|退行	anc
eternal	永遠の	anc
enthusiast	熱狂者	anc
mercy	慈悲|寛容|幸運	anc
incoming	入ってくる|引き継ぐ|後任の|新入りの	original
cleaner	掃除人|洗剤	anc
consultancy	顧問職	anc
spank	尻を平手打ちする|平手うち|をたたく|平手(スリッパ)で打つこと|(罰としてお尻を)ぴちゃりと打つ	anc
cushion	クッション	anc
remarkable	注目すべき|珍しい|驚くべき	anc
fossil	化石	anc
productive	生産的な|生産力のある|豊富な|多産な|を生じる	anc
expose	さらす|をあばく	anc
floppy	だらりと垂れた|弱い	anc
blink	まばたきする|きらめき|まばたき	anc
dim	はっきりしない|うす暗い|かすかな	anc
compliant	従順な|言いなりになる	anc
rational	道理にかなった|合理的な|理性的な|推理の|推論の	anc
hotmail	Hotmail	anc
legitimate	正当な|道理にかなった|合法な|合理的な|合法化する|正当化する	anc
grande	(スペイン語およびラテン系言語)大きいの意|人名	anc
isolation	遊離|孤立|孤独|分離|隔離	anc
carnival	カーニバル	anc
worthy	値する|尊敬に値する	anc
surge	波立つ|波のように打ち寄せる|沸き上がる|揺らぐ|急増する|うねり|高潮|動揺|大波|殺到|高まり	anc
blackberry	クロイチゴ|黒イチゴ	anc
sunrise	日の出	anc
precipitation	落下|降水(量)|大急ぎ	anc
lender	貸手	anc
redirect	宛名を書き変える|向け直す|リダイレクトする|出力先を変更する	anc
dietary	食事の|飲食規定(量)	anc
sustain	支える|被る|継続する|(法的に)承認する	anc
analyse	分析する	anc
sudden	突然の	anc
bumper	バンパー	anc
deduction	控除|差し引き|演繹法	anc
footage	フィート(feet)で計った長さ	anc
lyric	竪琴の伴奏にあわせた|叙情的な|叙情の|歌の|叙情詩|歌詞	anc
pause	休止(する)|小休止|躊躇|ちょっと止まる|ためらう	anc
adhesive	付着力のある|粘着性の|記憶から消えない	anc
renewable	更新しうる|再生しうる	anc
inspect	検査する|調べる	anc
silly	ぼうっとした|愚かな(stupid)|ばかげた(foolish)	anc
workout	試験|(スポーツ)練習|トレーニング|運動|骨の折れる仕事	anc
conspiracy	共同謀議|陰謀	anc
foul	不正な|反則の|不潔な|腐敗した|(天候が)荒れもようの|(綱など)もつれた|下品な|(野球)反則の|ファウルの	anc
wit	知力|分別|ウィット|機智 (複数形witsも使用)|(W-)人名	anc
revelation	(キリスト教)啓示|黙示|お告げ|暴露|発覚|新発見	anc
liner	裏を付けする人|定期船|線を引く人|はさみ金|線の	anc
convey	を伝える|を運ぶ	anc
wrist	手首|投げる|手先の力	anc
greeting	挨拶|あいさつ	anc
render	(人にあることを)する|にならしめる|与える|払う(give)|報いる|仕返す|翻訳する	anc
warn	に警告する	anc
landlord	家主|地主	anc
incomplete	不完全な	anc
rand	ランド(南アフリカの通貨単位, 複数形rand)	original
chubby	まるまる太った|丸ぽちゃの	anc
prohibit	禁止する|を禁じる|を制止する|を妨げる|予防する	anc
waiver	権利放棄	anc
epic	叙事詩の|英雄的な|叙事詩(のような)|大作|超大作	anc
hash	こま切れ肉料理|台無しにする	anc
rewrite	書き直す	anc
nightlife	夜遊び	anc
headache	頭痛がする|頭痛|悩みの種	anc
karma	カルマ|業|因縁|宿命	anc
excessive	過度の|必要以上の	anc
naughty	行儀が悪い|いたずらな|わんぱくな|下品な	anc
bot	検索ロボット|借りる|たかる	anc
drawer	引き出し	anc
endorsement	裏書き|賛成|確認|支持|承認	anc
unexpected	意外な|予期しない|突然の|意外の思いがけない事	anc
hint	ヒント|てがかり|手引き|ほのめかす|遠回しに言う	anc
characteristic	独特の|特有の|特性の|特質	anc
guru	《しばしばG-》ヒンズー教の教師|導師|尊敬する師(指導者)	ejdict
vocabulary	語彙|用語範囲|単語集	anc
virtue	長所|徳|美徳|善|貞節|美点|効力|きき目	anc
squirt	を噴出させる|注射器|を注ぎこむ	anc
consequently	その結果として|結果として|必然的に|したがって	anc
scrap	屑鉄|屑|小片|断片|切り抜き|くず|をくずにする･解体する|捨てる	anc
gotta	have gottenの略|持っている･貰った等の意|スラング	anc
enormous	莫大な|非常に大きい|巨大な|極悪な	anc
tick	カチカチいう音|カチカチと音を立てる|時を刻む|ダニ|いやなやつ	anc
quantitative	定量的な|量ではかれる|量に関する	anc
vip	最重要人物;ビップ|very important person	anc
livestock	家畜	anc
sustainability	持続可能性	anc
nutritional	栄養を補給する|健康や成長を促進させる	anc
subtitle	字幕	anc
freely	大っぴらに|自由に	anc
aquatic	水中の|水の|水生の	anc
timeline	タイムライン	anc
landmark	画期的な出来事|陸標	anc
deploy	展開(する･させる)|配備(する･させる)|分散(する･させる)	anc
sheer	全くの|険しい|直立の|切り立った	anc
readily	敏速に	anc
calibration	目盛り|検量|測定	anc
infinite	計り知れない|無限の	anc
licensee	免許された人|酒類販売免許をもつ人	anc
mil	1リットルの1000分の1の体積|1インチの1000分の1の長さ|米国の軍事機関向けのドメイン名|mil	anc
invisible	目に見えない|目にみえない|目につかない	anc
legally	法律的に|合法的に	anc
harness	馬具|ハーネス(装着帯)|装置|装備|(引き具を)付ける|利用する	anc
satisfactory	満足な|十分な	anc
funk	おじけ|憂うつな気分|臆病者|be in a funk|恐れる(尻ごみする|たじろぐ)|(米俗)悪臭|ファンク(ビートが強く野性味あるジャズやロック)|(F-)人名|姓	anc
telephony	電話通信;電話法(術)	ejdict
pursuit	追求|追跡	anc
fatal	致命的な	anc
briefly	ちょっと|簡単に|短く	anc
kitty	子猫	anc
graphical	グラフィカル|図形の|図表の	anc
detective	探偵の|探偵|刑事	anc
aerospace	航空宇宙(空間)|気圏(大気圏と大気圏外とで形成する)|航空宇宙科学	anc
fighter	戦う人|戦士	anc
meaningful	意味のある|意味深長な	anc
barely	かろうじて|ほとんど～ない|わずかに|僅かに	anc
wherever	どこでも|一体どこに|所ならどこへでも|どこへ～しようとも|いったいどこへ	anc
rug	じゅうたん|(床の一部をおおう)敷物|カーペット	anc
modular	＜module|モジュールの|＜modulus|モジュラス(係数|率|標準)の	anc
democrat	民主主義者|民主党	anc
scent	追跡する|におわす|におい|手がかり|嗅覚|匂い|香り|嗅ぎ付ける|匂わす	anc
rehab	リハビリテーション	anc
falcon	タカ|(タカ狩り用の)ハヤブサ	anc
mustang	(米国の)半野生馬	anc
basement	地下室|基底部|地階	anc
freezer	冷蔵庫|冷凍装置(庫･室)	anc
scoop	すくいあげる|ひとすくい|スコップ|小シャベル|すくいさじ|特ダネ|スクープ	anc
lily	ユリ|百合のような|優美な	anc
cigar	葉巻たばこ|たばこ	anc
imprint	強く印象づける|押印|感銘させる	anc
ana	語録|逸話集|小話|逸話	anc
pod	さや|小群|まゆ|卵のう	anc
overlap	一部重ね合わせる|一部重なり合う|重複	anc
listener	聞き手|聴講生	anc
vegetarian	菜食主義者	anc
peninsula	半島	anc
cayman	=caiman	ejdict
interstate	州間高速道路	anc
thanksgiving	感謝祭	anc
idol	偶像|神像|教神|謝った概念|まぼろし	anc
revenge	の復讐をする|復讐する|報復|仕返し|遺恨|復讐心	anc
standing	立っている|永続的な|状態|地位|身分	anc
equilibrium	平衡|釣り合い|均衡|感情の安定|平静	anc
cue	手掛り|合図	anc
woodland	森林|森林地帯	anc
nickel	ニッケル|元素記号Ni|白銅貨|ニッケル硬貨|(米)5セント	anc
gore	(特に戦い|けんかなどで傷から流れ出た)血|血の塊	ejdict
attain	に達する|達成する	anc
adaptation	適応|順応	anc
aqua	水	anc
acrylic	アクリル	anc
variance	変化|変動|くい違い|衝突|不和	anc
urgent	緊急の|緊迫した|催促する|執拗な	anc
sake	利益|ため|目的|理由	anc
freshman	1年生	anc
sticker	ステッカー|広告ビラ|固執者|刺し手	anc
satin	サテン(なめらかで光沢のある絹織物)|しゅす(織)	anc
eh	何だって|何とおっしゃいましたか|でしょう	anc
sailor	船員|水夫	anc
acre	エーカー(面積の単位:約4047㎡)|(複数形で)土地|地所	original
adapt	を適応させる|慣れさせる|適応する|を改変する	anc
pavilion	大型テント|展示館|パビリオン|観覧席|別棟	anc
accord	調和(する)|協定|合意(する)|一致|与える|agreement	anc
tilt	傾ける|斜めにする|に突撃する|構える|突き出す|傾き|斜面|討論|攻撃|馬上やり試合|やりで突く	anc
roughly	おおよそ	anc
objection	反対|難点|欠点|不服	anc
cradle	ゆりかご|発生地|揺り篭|幼時	anc
physically	物理(学)的に|物質的に|身体的に	anc
denial	否認|否定|拒否|拒絶	anc
consecutive	連続した|継続的な|引き続く|論理が一貫した|(文法)結果の	anc
banker	銀行家	anc
dome	丸天井	anc
junk	がらくた(にする)|麻薬|ジャンク(中国の平底帆船)|破棄する	anc
bunny	(俗)プレイガール|うさぎちゃん	anc
decay	衰えさせる|衰える|腐る|腐敗|虫歯になる|衰退する	anc
garbage	生ごみ|ごみ|廃物|あら|台所ゴミ|残飯|がらくた|屑	anc
franc	フラン(フランスなどの通貨単位)	anc
critique	批評|批判|評論	anc
extraction	摘出	anc
outfit	したく|用具一式|一行|供給する	anc
expedition	探検|旅行|長い旅|長征|遠征	anc
halo	後光|光輪|栄光|(太陽や月の)かさ	anc
accurately	きちんと|正確には	anc
knot	結び目|節|結ぶ	anc
nightmare	うなされること|悪夢(のような経験)|恐怖|夢魔	anc
upset	ひっくり返す|転覆させる|負かす|混乱させる	anc
slam	をピシャリと閉める|バタン(と閉まる)	anc
scenic	景色の|風景の|眺めがよい|情景描写の|舞台(上)の|舞台装置の|劇の|風景画	anc
gazette	新聞	anc
parliamentary	議会の	anc
fridge	冷蔵庫	anc
nut	木の実をひらう|ナット|堅果|木の実|ナッツ|やつ|男|がんこ者	anc
incidence	発生|落下|発生率･程度|範囲	anc
theology	神学	anc
oxide	酸化物	anc
sweatshirt	スウェットシャツ	anc
bye	さよなら	anc
mushroom	マッシュルーム|キノコ|成長の速い|成上り者	anc
metadata	非常に大量のデータ	anc
cos	レタスの一種	anc
makeup	組み立て|構造|性質|化粧	anc
somerset	にとんぼ返りをさせる|投げてひっくり返す	anc
thoroughly	すっかり|完全に|全く|徹底的に	anc
canoe	カヌー	original
intimate	親密な|懇意の|(婉曲語)性的関係のある	anc
qualification	資格|免許|能力|制限	anc
namely	すなわち	anc
dept	department	anc
consequence	成り行き|帰結|結果|結論|重要性|重大さ|因果関係	anc
clamp	とめ金|留め金|締め具	anc
marathon	マラソン|長時間続く	anc
systematic	手順のよい|組織的な|系統的な|体系的な	anc
merry	陽気な|快活な	anc
tribunal	裁き|裁判所|法廷|裁決機関|判事席	anc
marvel	不思議に思う|驚く|驚異|驚くべきこと	anc
disposition	性質|配置|廃棄	anc
tsunami	(日本語)津波	anc
mutant	突然変異による|突然変体|変種	anc
aquarium	水族館|ガラスの水槽	anc
communist	共産主義者	anc
idiot	まぬけ|ばか|あほう	anc