ant	アリ
arm	うで
bat	コウモリ
dog	イヌ
ear	耳
elephant	ゾウ
eye	目
face	顔
fat	太った
father	父
foot	足
fox	キツネ
hair	かみの毛
hand	手
head	頭
knee	ひざ
leg	あし
mother	母
mouse	ネズミ
mouth	口
neck	首
nose	鼻
pig	ブタ
shoulder	かた
teacher	先生
teeth	歯
