badminton	バドミントン
ballet	バレエ
baseball	野球
basketball	バスケットボール
boxing	ボクシング
dodgeball	ドッジボール
golf	ゴルフ
gym	体育館
jump	ジャンプする
marathon	マラソン
park	公園
play	遊ぶ
playground	運動場
run	走る
soccer	サッカー
surfing	サーフィン
swimming	水泳
tennis	テニス
volleyball	バレーボール
walk	歩く
